"ct_id","asofyear","total","i015tot","i1535tot","i3575tot","i75125tot","i125otot","origin","i015ori","i1535ori","i3575ori","i75125ori","i125ooori","denied","i015den","i1535den","i3575den","i75125den","i125oden","i015totp","i1535totp","i3575totp","i75125totp","i125ototp","originp","i015orip","i1535orip","i3575orip","i75125orip","i125ooorip","deniedp","i015denp","i1535denp","i3575denp","i75125denp","i125odenp"
"25001010100",2017,177,0,0,11,26,140,171,0,0,11,24,136,6,0,0,0,2,4,0,0,0.0621468926553672,0.146892655367232,0.790960451977401,0.966101694915254,0,0,0.064327485380117,0.140350877192982,0.795321637426901,0.0338983050847458,0,0,0,0.333333333333333,0.666666666666667
"25001010206",2017,90,0,1,8,12,69,85,0,0,8,11,66,5,0,1,0,1,3,0,0.0111111111111111,0.0888888888888889,0.133333333333333,0.766666666666667,0.944444444444444,0,0,0.0941176470588235,0.129411764705882,0.776470588235294,0.0555555555555556,0,0.2,0,0.2,0.6
"25001010208",2017,65,0,1,4,5,55,60,0,1,4,5,50,5,0,0,0,0,5,0,0.0153846153846154,0.0615384615384615,0.0769230769230769,0.846153846153846,0.923076923076923,0,0.0166666666666667,0.0666666666666667,0.0833333333333333,0.833333333333333,0.0769230769230769,0,0,0,0,1
"25001010304",2017,69,0,0,8,17,44,61,0,0,5,14,42,8,0,0,3,3,2,0,0,0.115942028985507,0.246376811594203,0.63768115942029,0.884057971014493,0,0,0.0819672131147541,0.229508196721311,0.688524590163934,0.115942028985507,0,0,0.375,0.375,0.25
"25001010306",2017,86,0,2,12,24,48,81,0,2,10,22,47,5,0,0,2,2,1,0,0.0232558139534884,0.13953488372093,0.27906976744186,0.558139534883721,0.941860465116279,0,0.0246913580246914,0.123456790123457,0.271604938271605,0.580246913580247,0.0581395348837209,0,0,0.4,0.4,0.2
"25001010400",2017,53,0,3,13,10,27,46,0,1,11,9,25,7,0,2,2,1,2,0,0.0566037735849057,0.245283018867925,0.188679245283019,0.509433962264151,0.867924528301887,0,0.0217391304347826,0.239130434782609,0.195652173913043,0.543478260869565,0.132075471698113,0,0.285714285714286,0.285714285714286,0.142857142857143,0.285714285714286
"25001010500",2017,55,0,0,3,12,40,52,0,0,3,9,40,3,0,0,0,3,0,0,0,0.0545454545454545,0.218181818181818,0.727272727272727,0.945454545454545,0,0,0.0576923076923077,0.173076923076923,0.769230769230769,0.0545454545454545,0,0,0,1,0
"25001010600",2017,70,0,0,7,7,56,68,0,0,6,7,55,2,0,0,1,0,1,0,0,0.1,0.1,0.8,0.971428571428571,0,0,0.0882352941176471,0.102941176470588,0.808823529411765,0.0285714285714286,0,0,0.5,0,0.5
"25001010700",2017,120,0,1,5,12,102,112,0,1,4,11,96,8,0,0,1,1,6,0,0.00833333333333333,0.0416666666666667,0.1,0.85,0.933333333333333,0,0.00892857142857143,0.0357142857142857,0.0982142857142857,0.857142857142857,0.0666666666666667,0,0,0.125,0.125,0.75
"25001010800",2017,120,0,0,18,28,74,114,0,0,17,25,72,6,0,0,1,3,2,0,0,0.15,0.233333333333333,0.616666666666667,0.95,0,0,0.149122807017544,0.219298245614035,0.631578947368421,0.05,0,0,0.166666666666667,0.5,0.333333333333333
"25001010900",2017,132,0,5,29,29,69,125,0,5,27,27,66,7,0,0,2,2,3,0,0.0378787878787879,0.21969696969697,0.21969696969697,0.522727272727273,0.946969696969697,0,0.04,0.216,0.216,0.528,0.053030303030303,0,0,0.285714285714286,0.285714285714286,0.428571428571429
"25001011002",2017,109,0,2,19,32,56,102,0,2,16,29,55,7,0,0,3,3,1,0,0.018348623853211,0.174311926605505,0.293577981651376,0.513761467889908,0.935779816513762,0,0.0196078431372549,0.156862745098039,0.284313725490196,0.53921568627451,0.0642201834862385,0,0,0.428571428571429,0.428571428571429,0.142857142857143
"25001011100",2017,106,0,1,26,27,52,102,0,1,24,27,50,4,0,0,2,0,2,0,0.00943396226415094,0.245283018867925,0.254716981132075,0.490566037735849,0.962264150943396,0,0.00980392156862745,0.235294117647059,0.264705882352941,0.490196078431373,0.0377358490566038,0,0,0.5,0,0.5
"25001011200",2017,104,1,3,18,23,59,97,1,2,16,22,56,7,0,1,2,1,3,0.00961538461538462,0.0288461538461538,0.173076923076923,0.221153846153846,0.567307692307692,0.932692307692308,0.0103092783505155,0.0206185567010309,0.164948453608247,0.22680412371134,0.577319587628866,0.0673076923076923,0,0.142857142857143,0.285714285714286,0.142857142857143,0.428571428571429
"25001011300",2017,65,0,0,13,12,40,61,0,0,12,10,39,4,0,0,1,2,1,0,0,0.2,0.184615384615385,0.615384615384615,0.938461538461538,0,0,0.19672131147541,0.163934426229508,0.639344262295082,0.0615384615384615,0,0,0.25,0.5,0.25
"25001011400",2017,62,0,1,15,17,29,58,0,1,14,15,28,4,0,0,1,2,1,0,0.0161290322580645,0.241935483870968,0.274193548387097,0.467741935483871,0.935483870967742,0,0.0172413793103448,0.241379310344828,0.258620689655172,0.482758620689655,0.0645161290322581,0,0,0.25,0.5,0.25
"25001011500",2017,88,0,2,30,20,36,84,0,1,30,19,34,4,0,1,0,1,2,0,0.0227272727272727,0.340909090909091,0.227272727272727,0.409090909090909,0.954545454545455,0,0.0119047619047619,0.357142857142857,0.226190476190476,0.404761904761905,0.0454545454545455,0,0.25,0,0.25,0.5
"25001011600",2017,151,1,0,20,34,96,136,1,0,16,30,89,15,0,0,4,4,7,0.00662251655629139,0,0.132450331125828,0.225165562913907,0.635761589403974,0.900662251655629,0.00735294117647059,0,0.117647058823529,0.220588235294118,0.654411764705882,0.0993377483443709,0,0,0.266666666666667,0.266666666666667,0.466666666666667
"25001011700",2017,65,0,0,3,17,45,59,0,0,2,14,43,6,0,0,1,3,2,0,0,0.0461538461538462,0.261538461538462,0.692307692307692,0.907692307692308,0,0,0.0338983050847458,0.23728813559322,0.728813559322034,0.0923076923076923,0,0,0.166666666666667,0.5,0.333333333333333
"25001011801",2017,39,0,0,5,11,23,37,0,0,4,10,23,2,0,0,1,1,0,0,0,0.128205128205128,0.282051282051282,0.58974358974359,0.948717948717949,0,0,0.108108108108108,0.27027027027027,0.621621621621622,0.0512820512820513,0,0,0.5,0.5,0
"25001011802",2017,81,0,2,26,18,35,79,0,2,25,18,34,2,0,0,1,0,1,0,0.0246913580246914,0.320987654320988,0.222222222222222,0.432098765432099,0.975308641975309,0,0.0253164556962025,0.316455696202532,0.227848101265823,0.430379746835443,0.0246913580246914,0,0,0.5,0,0.5
"25001012001",2017,119,0,1,50,39,29,107,0,1,43,37,26,12,0,0,7,2,3,0,0.00840336134453781,0.420168067226891,0.327731092436975,0.243697478991597,0.899159663865546,0,0.00934579439252336,0.401869158878505,0.345794392523364,0.242990654205607,0.100840336134454,0,0,0.583333333333333,0.166666666666667,0.25
"25001012002",2017,89,1,1,23,16,48,80,0,0,20,15,45,9,1,1,3,1,3,0.0112359550561798,0.0112359550561798,0.258426966292135,0.179775280898876,0.539325842696629,0.898876404494382,0,0,0.25,0.1875,0.5625,0.101123595505618,0.111111111111111,0.111111111111111,0.333333333333333,0.111111111111111,0.333333333333333
"25001012101",2017,144,0,5,69,51,19,127,0,4,60,45,18,17,0,1,9,6,1,0,0.0347222222222222,0.479166666666667,0.354166666666667,0.131944444444444,0.881944444444444,0,0.031496062992126,0.47244094488189,0.354330708661417,0.141732283464567,0.118055555555556,0,0.0588235294117647,0.529411764705882,0.352941176470588,0.0588235294117647
"25001012102",2017,90,0,4,22,21,43,82,0,4,18,20,40,8,0,0,4,1,3,0,0.0444444444444444,0.244444444444444,0.233333333333333,0.477777777777778,0.911111111111111,0,0.0487804878048781,0.219512195121951,0.24390243902439,0.48780487804878,0.0888888888888889,0,0,0.5,0.125,0.375
"25001012200",2017,95,0,0,16,25,54,86,0,0,12,23,51,9,0,0,4,2,3,0,0,0.168421052631579,0.263157894736842,0.568421052631579,0.905263157894737,0,0,0.13953488372093,0.267441860465116,0.593023255813954,0.0947368421052632,0,0,0.444444444444444,0.222222222222222,0.333333333333333
"25001012502",2017,70,0,2,22,16,30,67,0,2,21,15,29,3,0,0,1,1,1,0,0.0285714285714286,0.314285714285714,0.228571428571429,0.428571428571429,0.957142857142857,0,0.0298507462686567,0.313432835820896,0.223880597014925,0.432835820895522,0.0428571428571429,0,0,0.333333333333333,0.333333333333333,0.333333333333333
"25001012601",2017,54,0,0,36,12,6,49,0,0,31,12,6,5,0,0,5,0,0,0,0,0.666666666666667,0.222222222222222,0.111111111111111,0.907407407407407,0,0,0.63265306122449,0.244897959183673,0.122448979591837,0.0925925925925926,0,0,1,0,0
"25001012602",2017,83,1,4,63,10,5,70,0,3,53,10,4,13,1,1,10,0,1,0.0120481927710843,0.0481927710843374,0.759036144578313,0.120481927710843,0.0602409638554217,0.843373493975904,0,0.0428571428571429,0.757142857142857,0.142857142857143,0.0571428571428571,0.156626506024096,0.0769230769230769,0.0769230769230769,0.769230769230769,0,0.0769230769230769
"25001012700",2017,121,0,4,26,35,56,108,0,3,22,32,51,13,0,1,4,3,5,0,0.0330578512396694,0.214876033057851,0.289256198347107,0.462809917355372,0.892561983471074,0,0.0277777777777778,0.203703703703704,0.296296296296296,0.472222222222222,0.107438016528926,0,0.0769230769230769,0.307692307692308,0.230769230769231,0.384615384615385
"25001012800",2017,58,0,2,19,19,18,54,0,2,18,17,17,4,0,0,1,2,1,0,0.0344827586206897,0.327586206896552,0.327586206896552,0.310344827586207,0.931034482758621,0,0.037037037037037,0.333333333333333,0.314814814814815,0.314814814814815,0.0689655172413793,0,0,0.25,0.5,0.25
"25001012900",2017,90,2,2,42,28,16,80,1,1,37,27,14,10,1,1,5,1,2,0.0222222222222222,0.0222222222222222,0.466666666666667,0.311111111111111,0.177777777777778,0.888888888888889,0.0125,0.0125,0.4625,0.3375,0.175,0.111111111111111,0.1,0.1,0.5,0.1,0.2
"25001013002",2017,95,0,1,6,24,64,87,0,1,6,21,59,8,0,0,0,3,5,0,0.0105263157894737,0.0631578947368421,0.252631578947368,0.673684210526316,0.91578947368421,0,0.0114942528735632,0.0689655172413793,0.241379310344828,0.67816091954023,0.0842105263157895,0,0,0,0.375,0.625
"25001013100",2017,105,0,4,30,43,28,93,0,2,25,40,26,12,0,2,5,3,2,0,0.0380952380952381,0.285714285714286,0.40952380952381,0.266666666666667,0.885714285714286,0,0.021505376344086,0.268817204301075,0.43010752688172,0.279569892473118,0.114285714285714,0,0.166666666666667,0.416666666666667,0.25,0.166666666666667
"25001013200",2017,102,0,0,25,33,44,99,0,0,22,33,44,3,0,0,3,0,0,0,0,0.245098039215686,0.323529411764706,0.431372549019608,0.970588235294118,0,0,0.222222222222222,0.333333333333333,0.444444444444444,0.0294117647058824,0,0,1,0,0
"25001013300",2017,71,0,0,11,24,36,64,0,0,11,20,33,7,0,0,0,4,3,0,0,0.154929577464789,0.338028169014085,0.507042253521127,0.901408450704225,0,0,0.171875,0.3125,0.515625,0.0985915492957746,0,0,0,0.571428571428571,0.428571428571429
"25001013400",2017,98,0,0,14,24,60,92,0,0,11,23,58,6,0,0,3,1,2,0,0,0.142857142857143,0.244897959183673,0.612244897959184,0.938775510204082,0,0,0.119565217391304,0.25,0.630434782608696,0.0612244897959184,0,0,0.5,0.166666666666667,0.333333333333333
"25001013500",2017,118,0,0,30,48,40,114,0,0,29,46,39,4,0,0,1,2,1,0,0,0.254237288135593,0.406779661016949,0.338983050847458,0.966101694915254,0,0,0.254385964912281,0.403508771929825,0.342105263157895,0.0338983050847458,0,0,0.25,0.5,0.25
"25001013600",2017,102,0,1,32,44,25,92,0,1,25,42,24,10,0,0,7,2,1,0,0.00980392156862745,0.313725490196078,0.431372549019608,0.245098039215686,0.901960784313726,0,0.0108695652173913,0.271739130434783,0.456521739130435,0.260869565217391,0.0980392156862745,0,0,0.7,0.2,0.1
"25001013700",2017,64,0,0,19,27,18,59,0,0,16,25,18,5,0,0,3,2,0,0,0,0.296875,0.421875,0.28125,0.921875,0,0,0.271186440677966,0.423728813559322,0.305084745762712,0.078125,0,0,0.6,0.4,0
"25001013800",2017,99,0,0,21,42,36,92,0,0,19,38,35,7,0,0,2,4,1,0,0,0.212121212121212,0.424242424242424,0.363636363636364,0.929292929292929,0,0,0.206521739130435,0.41304347826087,0.380434782608696,0.0707070707070707,0,0,0.285714285714286,0.571428571428571,0.142857142857143
"25001013900",2017,127,0,3,31,37,56,120,0,3,26,36,55,7,0,0,5,1,1,0,0.0236220472440945,0.244094488188976,0.291338582677165,0.440944881889764,0.94488188976378,0,0.025,0.216666666666667,0.3,0.458333333333333,0.0551181102362205,0,0,0.714285714285714,0.142857142857143,0.142857142857143
"25001014002",2017,79,0,3,16,22,38,70,0,1,12,21,36,9,0,2,4,1,2,0,0.0379746835443038,0.20253164556962,0.278481012658228,0.481012658227848,0.886075949367089,0,0.0142857142857143,0.171428571428571,0.3,0.514285714285714,0.113924050632911,0,0.222222222222222,0.444444444444444,0.111111111111111,0.222222222222222
"25001014300",2017,90,0,1,6,21,62,84,0,0,5,20,59,6,0,1,1,1,3,0,0.0111111111111111,0.0666666666666667,0.233333333333333,0.688888888888889,0.933333333333333,0,0,0.0595238095238095,0.238095238095238,0.702380952380952,0.0666666666666667,0,0.166666666666667,0.166666666666667,0.166666666666667,0.5
"25001014402",2017,117,0,3,33,41,40,110,0,2,29,39,40,7,0,1,4,2,0,0,0.0256410256410256,0.282051282051282,0.35042735042735,0.341880341880342,0.94017094017094,0,0.0181818181818182,0.263636363636364,0.354545454545455,0.363636363636364,0.0598290598290598,0,0.142857142857143,0.571428571428571,0.285714285714286,0
"25001014500",2017,103,0,1,31,29,42,95,0,0,27,28,40,8,0,1,4,1,2,0,0.00970873786407767,0.300970873786408,0.281553398058252,0.407766990291262,0.922330097087379,0,0,0.284210526315789,0.294736842105263,0.421052631578947,0.0776699029126214,0,0.125,0.5,0.125,0.25
"25001014600",2017,93,0,2,25,21,45,86,0,2,21,19,44,7,0,0,4,2,1,0,0.021505376344086,0.268817204301075,0.225806451612903,0.483870967741935,0.924731182795699,0,0.0232558139534884,0.244186046511628,0.22093023255814,0.511627906976744,0.0752688172043011,0,0,0.571428571428571,0.285714285714286,0.142857142857143
"25001014700",2017,108,1,2,26,23,56,96,0,0,21,21,54,12,1,2,5,2,2,0.00925925925925926,0.0185185185185185,0.240740740740741,0.212962962962963,0.518518518518518,0.888888888888889,0,0,0.21875,0.21875,0.5625,0.111111111111111,0.0833333333333333,0.166666666666667,0.416666666666667,0.166666666666667,0.166666666666667
"25001014800",2017,64,0,0,7,16,41,60,0,0,6,15,39,4,0,0,1,1,2,0,0,0.109375,0.25,0.640625,0.9375,0,0,0.1,0.25,0.65,0.0625,0,0,0.25,0.25,0.5
"25001014900",2017,54,0,0,2,9,43,53,0,0,2,9,42,1,0,0,0,0,1,0,0,0.037037037037037,0.166666666666667,0.796296296296296,0.981481481481482,0,0,0.0377358490566038,0.169811320754717,0.792452830188679,0.0185185185185185,0,0,0,0,1
"25001015001",2017,75,1,0,35,28,11,70,0,0,34,26,10,5,1,0,1,2,1,0.0133333333333333,0,0.466666666666667,0.373333333333333,0.146666666666667,0.933333333333333,0,0,0.485714285714286,0.371428571428571,0.142857142857143,0.0666666666666667,0.2,0,0.2,0.4,0.2
"25001015002",2017,116,1,5,33,47,30,106,0,4,30,43,29,10,1,1,3,4,1,0.00862068965517241,0.0431034482758621,0.28448275862069,0.405172413793103,0.258620689655172,0.913793103448276,0,0.0377358490566038,0.283018867924528,0.405660377358491,0.273584905660377,0.0862068965517241,0.1,0.1,0.3,0.4,0.1
"25001015100",2017,115,0,3,35,35,42,105,0,2,31,31,41,10,0,1,4,4,1,0,0.0260869565217391,0.304347826086957,0.304347826086957,0.365217391304348,0.91304347826087,0,0.019047619047619,0.295238095238095,0.295238095238095,0.39047619047619,0.0869565217391304,0,0.1,0.4,0.4,0.1
"25001015200",2017,139,0,0,7,17,115,132,0,0,6,17,109,7,0,0,1,0,6,0,0,0.0503597122302158,0.122302158273381,0.827338129496403,0.949640287769784,0,0,0.0454545454545455,0.128787878787879,0.825757575757576,0.0503597122302158,0,0,0.142857142857143,0,0.857142857142857
"25001015300",2017,41,0,2,20,12,7,37,0,2,17,11,7,4,0,0,3,1,0,0,0.0487804878048781,0.48780487804878,0.292682926829268,0.170731707317073,0.902439024390244,0,0.0540540540540541,0.459459459459459,0.297297297297297,0.189189189189189,0.0975609756097561,0,0,0.75,0.25,0
"25003900100",2017,11,0,2,3,3,3,9,0,2,3,1,3,2,0,0,0,2,0,0,0.181818181818182,0.272727272727273,0.272727272727273,0.272727272727273,0.818181818181818,0,0.222222222222222,0.333333333333333,0.111111111111111,0.333333333333333,0.181818181818182,0,0,0,1,0
"25003900200",2017,28,1,7,17,1,2,24,1,3,17,1,2,4,0,4,0,0,0,0.0357142857142857,0.25,0.607142857142857,0.0357142857142857,0.0714285714285714,0.857142857142857,0.0416666666666667,0.125,0.708333333333333,0.0416666666666667,0.0833333333333333,0.142857142857143,0,1,0,0,0
"25003900300",2017,43,1,5,25,10,2,39,1,4,22,10,2,4,0,1,3,0,0,0.0232558139534884,0.116279069767442,0.581395348837209,0.232558139534884,0.0465116279069767,0.906976744186046,0.0256410256410256,0.102564102564103,0.564102564102564,0.256410256410256,0.0512820512820513,0.0930232558139535,0,0.25,0.75,0,0
"25003900400",2017,59,0,5,32,10,12,53,0,3,30,9,11,6,0,2,2,1,1,0,0.0847457627118644,0.542372881355932,0.169491525423729,0.203389830508475,0.898305084745763,0,0.0566037735849057,0.566037735849057,0.169811320754717,0.207547169811321,0.101694915254237,0,0.333333333333333,0.333333333333333,0.166666666666667,0.166666666666667
"25003900500",2017,43,0,2,24,9,8,42,0,2,23,9,8,1,0,0,1,0,0,0,0.0465116279069767,0.558139534883721,0.209302325581395,0.186046511627907,0.976744186046512,0,0.0476190476190476,0.547619047619048,0.214285714285714,0.19047619047619,0.0232558139534884,0,0,1,0,0
"25003900600",2017,25,3,5,11,4,2,21,1,3,11,4,2,4,2,2,0,0,0,0.12,0.2,0.44,0.16,0.08,0.84,0.0476190476190476,0.142857142857143,0.523809523809524,0.19047619047619,0.0952380952380952,0.16,0.5,0.5,0,0,0
"25003900700",2017,38,0,6,23,6,3,35,0,4,22,6,3,3,0,2,1,0,0,0,0.157894736842105,0.605263157894737,0.157894736842105,0.0789473684210526,0.921052631578947,0,0.114285714285714,0.628571428571429,0.171428571428571,0.0857142857142857,0.0789473684210526,0,0.666666666666667,0.333333333333333,0,0
"25003900800",2017,82,0,5,34,25,18,76,0,3,33,23,17,6,0,2,1,2,1,0,0.0609756097560976,0.414634146341463,0.304878048780488,0.219512195121951,0.926829268292683,0,0.0394736842105263,0.434210526315789,0.302631578947368,0.223684210526316,0.0731707317073171,0,0.333333333333333,0.166666666666667,0.333333333333333,0.166666666666667
"25003900900",2017,70,0,13,28,15,14,63,0,11,24,14,14,7,0,2,4,1,0,0,0.185714285714286,0.4,0.214285714285714,0.2,0.9,0,0.174603174603175,0.380952380952381,0.222222222222222,0.222222222222222,0.1,0,0.285714285714286,0.571428571428571,0.142857142857143,0
"25003901100",2017,74,0,16,41,13,4,63,0,11,36,13,3,11,0,5,5,0,1,0,0.216216216216216,0.554054054054054,0.175675675675676,0.0540540540540541,0.851351351351351,0,0.174603174603175,0.571428571428571,0.206349206349206,0.0476190476190476,0.148648648648649,0,0.454545454545455,0.454545454545455,0,0.0909090909090909
"25003911100",2017,53,1,2,18,16,16,49,1,1,16,15,16,4,0,1,2,1,0,0.0188679245283019,0.0377358490566038,0.339622641509434,0.30188679245283,0.30188679245283,0.924528301886792,0.0204081632653061,0.0204081632653061,0.326530612244898,0.306122448979592,0.326530612244898,0.0754716981132075,0,0.25,0.5,0.25,0
"25003912100",2017,107,0,5,48,33,21,95,0,4,44,26,21,12,0,1,4,7,0,0,0.0467289719626168,0.448598130841121,0.308411214953271,0.196261682242991,0.88785046728972,0,0.0421052631578947,0.463157894736842,0.273684210526316,0.221052631578947,0.11214953271028,0,0.0833333333333333,0.333333333333333,0.583333333333333,0
"25003913100",2017,79,1,2,22,16,38,71,0,1,19,16,35,8,1,1,3,0,3,0.0126582278481013,0.0253164556962025,0.278481012658228,0.20253164556962,0.481012658227848,0.89873417721519,0,0.0140845070422535,0.267605633802817,0.225352112676056,0.492957746478873,0.10126582278481,0.125,0.125,0.375,0,0.375
"25003914100",2017,73,0,4,34,16,19,63,0,2,29,14,18,10,0,2,5,2,1,0,0.0547945205479452,0.465753424657534,0.219178082191781,0.26027397260274,0.863013698630137,0,0.0317460317460317,0.46031746031746,0.222222222222222,0.285714285714286,0.136986301369863,0,0.2,0.5,0.2,0.1
"25003920101",2017,62,0,1,15,23,23,59,0,1,14,22,22,3,0,0,1,1,1,0,0.0161290322580645,0.241935483870968,0.370967741935484,0.370967741935484,0.951612903225806,0,0.0169491525423729,0.23728813559322,0.372881355932203,0.372881355932203,0.0483870967741935,0,0,0.333333333333333,0.333333333333333,0.333333333333333
"25003920102",2017,27,0,2,9,3,13,24,0,2,8,2,12,3,0,0,1,1,1,0,0.0740740740740741,0.333333333333333,0.111111111111111,0.481481481481481,0.888888888888889,0,0.0833333333333333,0.333333333333333,0.0833333333333333,0.5,0.111111111111111,0,0,0.333333333333333,0.333333333333333,0.333333333333333
"25003921300",2017,38,0,10,18,9,1,30,0,8,14,8,0,8,0,2,4,1,1,0,0.263157894736842,0.473684210526316,0.236842105263158,0.0263157894736842,0.789473684210526,0,0.266666666666667,0.466666666666667,0.266666666666667,0,0.210526315789474,0,0.25,0.5,0.125,0.125
"25003921400",2017,13,0,3,6,3,1,8,0,0,5,2,1,5,0,3,1,1,0,0,0.230769230769231,0.461538461538462,0.230769230769231,0.0769230769230769,0.615384615384615,0,0,0.625,0.25,0.125,0.384615384615385,0,0.6,0.2,0.2,0
"25003921500",2017,35,0,5,18,10,2,33,0,5,17,9,2,2,0,0,1,1,0,0,0.142857142857143,0.514285714285714,0.285714285714286,0.0571428571428571,0.942857142857143,0,0.151515151515152,0.515151515151515,0.272727272727273,0.0606060606060606,0.0571428571428571,0,0,0.5,0.5,0
"25003922100",2017,19,1,2,13,3,0,16,1,1,11,3,0,3,0,1,2,0,0,0.0526315789473684,0.105263157894737,0.684210526315789,0.157894736842105,0,0.842105263157895,0.0625,0.0625,0.6875,0.1875,0,0.157894736842105,0,0.333333333333333,0.666666666666667,0,0
"25003922200",2017,52,2,16,27,4,3,42,1,14,22,3,2,10,1,2,5,1,1,0.0384615384615385,0.307692307692308,0.519230769230769,0.0769230769230769,0.0576923076923077,0.807692307692308,0.0238095238095238,0.333333333333333,0.523809523809524,0.0714285714285714,0.0476190476190476,0.192307692307692,0.1,0.2,0.5,0.1,0.1
"25003922300",2017,27,0,2,18,7,0,21,0,1,16,4,0,6,0,1,2,3,0,0,0.0740740740740741,0.666666666666667,0.259259259259259,0,0.777777777777778,0,0.0476190476190476,0.761904761904762,0.19047619047619,0,0.222222222222222,0,0.166666666666667,0.333333333333333,0.5,0
"25003923100",2017,41,0,3,13,19,6,36,0,3,12,15,6,5,0,0,1,4,0,0,0.0731707317073171,0.317073170731707,0.463414634146341,0.146341463414634,0.878048780487805,0,0.0833333333333333,0.333333333333333,0.416666666666667,0.166666666666667,0.121951219512195,0,0,0.2,0.8,0
"25003924100",2017,22,0,0,4,3,15,19,0,0,4,3,12,3,0,0,0,0,3,0,0,0.181818181818182,0.136363636363636,0.681818181818182,0.863636363636364,0,0,0.210526315789474,0.157894736842105,0.631578947368421,0.136363636363636,0,0,0,0,1
"25003925100",2017,68,0,1,29,9,29,62,0,1,26,8,27,6,0,0,3,1,2,0,0.0147058823529412,0.426470588235294,0.132352941176471,0.426470588235294,0.911764705882353,0,0.0161290322580645,0.419354838709677,0.129032258064516,0.435483870967742,0.0882352941176471,0,0,0.5,0.166666666666667,0.333333333333333
"25003926100",2017,53,0,4,18,10,21,48,0,2,16,9,21,5,0,2,2,1,0,0,0.0754716981132075,0.339622641509434,0.188679245283019,0.39622641509434,0.905660377358491,0,0.0416666666666667,0.333333333333333,0.1875,0.4375,0.0943396226415094,0,0.4,0.4,0.2,0
"25003931100",2017,21,0,2,9,8,2,18,0,2,8,8,0,3,0,0,1,0,2,0,0.0952380952380952,0.428571428571429,0.380952380952381,0.0952380952380952,0.857142857142857,0,0.111111111111111,0.444444444444444,0.444444444444444,0,0.142857142857143,0,0,0.333333333333333,0,0.666666666666667
"25003931300",2017,16,0,4,8,4,0,13,0,2,7,4,0,3,0,2,1,0,0,0,0.25,0.5,0.25,0,0.8125,0,0.153846153846154,0.538461538461538,0.307692307692308,0,0.1875,0,0.666666666666667,0.333333333333333,0,0
"25003931400",2017,18,0,1,7,7,3,16,0,1,7,5,3,2,0,0,0,2,0,0,0.0555555555555556,0.388888888888889,0.388888888888889,0.166666666666667,0.888888888888889,0,0.0625,0.4375,0.3125,0.1875,0.111111111111111,0,0,0,1,0
"25003932200",2017,56,0,3,21,17,15,50,0,3,16,17,14,6,0,0,5,0,1,0,0.0535714285714286,0.375,0.303571428571429,0.267857142857143,0.892857142857143,0,0.06,0.32,0.34,0.28,0.107142857142857,0,0,0.833333333333333,0,0.166666666666667
"25003932300",2017,24,0,3,6,10,5,23,0,2,6,10,5,1,0,1,0,0,0,0,0.125,0.25,0.416666666666667,0.208333333333333,0.958333333333333,0,0.0869565217391304,0.260869565217391,0.434782608695652,0.217391304347826,0.0416666666666667,0,1,0,0,0
"25003933200",2017,17,0,0,1,1,15,15,0,0,0,1,14,2,0,0,1,0,1,0,0,0.0588235294117647,0.0588235294117647,0.882352941176471,0.882352941176471,0,0,0,0.0666666666666667,0.933333333333333,0.117647058823529,0,0,0.5,0,0.5
"25003933300",2017,15,0,1,3,3,8,15,0,1,3,3,8,0,0,0,0,0,0,0,0.0666666666666667,0.2,0.2,0.533333333333333,1,0,0.0666666666666667,0.2,0.2,0.533333333333333,0,0,0,0,0,0
"25003933400",2017,35,0,6,8,8,13,32,0,6,7,8,11,3,0,0,1,0,2,0,0.171428571428571,0.228571428571429,0.228571428571429,0.371428571428571,0.914285714285714,0,0.1875,0.21875,0.25,0.34375,0.0857142857142857,0,0,0.333333333333333,0,0.666666666666667
"25003934200",2017,22,0,2,6,4,10,21,0,2,5,4,10,1,0,0,1,0,0,0,0.0909090909090909,0.272727272727273,0.181818181818182,0.454545454545455,0.954545454545455,0,0.0952380952380952,0.238095238095238,0.19047619047619,0.476190476190476,0.0454545454545455,0,0,1,0,0
"25003934300",2017,32,0,1,7,4,20,26,0,0,7,2,17,6,0,1,0,2,3,0,0.03125,0.21875,0.125,0.625,0.8125,0,0,0.269230769230769,0.0769230769230769,0.653846153846154,0.1875,0,0.166666666666667,0,0.333333333333333,0.5
"25003935100",2017,36,0,0,10,12,14,36,0,0,10,12,14,0,0,0,0,0,0,0,0,0.277777777777778,0.333333333333333,0.388888888888889,1,0,0,0.277777777777778,0.333333333333333,0.388888888888889,0,0,0,0,0,0
"25003935200",2017,85,0,12,47,21,5,78,0,9,44,20,5,7,0,3,3,1,0,0,0.141176470588235,0.552941176470588,0.247058823529412,0.0588235294117647,0.917647058823529,0,0.115384615384615,0.564102564102564,0.256410256410256,0.0641025641025641,0.0823529411764706,0,0.428571428571429,0.428571428571429,0.142857142857143,0
"25003935300",2017,42,0,4,19,10,9,38,0,3,18,10,7,4,0,1,1,0,2,0,0.0952380952380952,0.452380952380952,0.238095238095238,0.214285714285714,0.904761904761905,0,0.0789473684210526,0.473684210526316,0.263157894736842,0.184210526315789,0.0952380952380952,0,0.25,0.25,0,0.5
"25005600100",2017,49,0,0,12,24,13,47,0,0,12,22,13,2,0,0,0,2,0,0,0,0.244897959183673,0.489795918367347,0.26530612244898,0.959183673469388,0,0,0.25531914893617,0.468085106382979,0.276595744680851,0.0408163265306122,0,0,0,1,0
"25005600202",2017,127,0,2,59,35,31,115,0,2,52,32,29,12,0,0,7,3,2,0,0.015748031496063,0.464566929133858,0.275590551181102,0.244094488188976,0.905511811023622,0,0.0173913043478261,0.452173913043478,0.278260869565217,0.252173913043478,0.094488188976378,0,0,0.583333333333333,0.25,0.166666666666667
"25005600203",2017,69,0,0,6,25,38,66,0,0,6,24,36,3,0,0,0,1,2,0,0,0.0869565217391304,0.36231884057971,0.550724637681159,0.956521739130435,0,0,0.0909090909090909,0.363636363636364,0.545454545454545,0.0434782608695652,0,0,0,0.333333333333333,0.666666666666667
"25005600204",2017,63,0,1,9,17,36,58,0,1,9,13,35,5,0,0,0,4,1,0,0.0158730158730159,0.142857142857143,0.26984126984127,0.571428571428571,0.920634920634921,0,0.0172413793103448,0.155172413793103,0.224137931034483,0.603448275862069,0.0793650793650794,0,0,0,0.8,0.2
"25005610100",2017,76,1,0,15,30,30,69,0,0,14,26,29,7,1,0,1,4,1,0.0131578947368421,0,0.197368421052632,0.394736842105263,0.394736842105263,0.907894736842105,0,0,0.202898550724638,0.376811594202899,0.420289855072464,0.0921052631578947,0.142857142857143,0,0.142857142857143,0.571428571428571,0.142857142857143
"25005610202",2017,71,0,0,7,29,35,69,0,0,7,27,35,2,0,0,0,2,0,0,0,0.0985915492957746,0.408450704225352,0.492957746478873,0.971830985915493,0,0,0.101449275362319,0.391304347826087,0.507246376811594,0.028169014084507,0,0,0,1,0
"25005610203",2017,79,0,0,8,21,50,75,0,0,7,20,48,4,0,0,1,1,2,0,0,0.10126582278481,0.265822784810127,0.632911392405063,0.949367088607595,0,0,0.0933333333333333,0.266666666666667,0.64,0.0506329113924051,0,0,0.25,0.25,0.5
"25005610204",2017,67,0,2,17,15,33,61,0,1,15,14,31,6,0,1,2,1,2,0,0.0298507462686567,0.253731343283582,0.223880597014925,0.492537313432836,0.91044776119403,0,0.0163934426229508,0.245901639344262,0.229508196721311,0.508196721311475,0.0895522388059701,0,0.166666666666667,0.333333333333333,0.166666666666667,0.333333333333333
"25005611101",2017,80,0,1,22,28,29,73,0,1,21,25,26,7,0,0,1,3,3,0,0.0125,0.275,0.35,0.3625,0.9125,0,0.0136986301369863,0.287671232876712,0.342465753424658,0.356164383561644,0.0875,0,0,0.142857142857143,0.428571428571429,0.428571428571429
"25005611102",2017,37,0,1,6,14,16,37,0,1,6,14,16,0,0,0,0,0,0,0,0.027027027027027,0.162162162162162,0.378378378378378,0.432432432432432,1,0,0.027027027027027,0.162162162162162,0.378378378378378,0.432432432432432,0,0,0,0,0,0
"25005611201",2017,47,0,0,9,19,19,40,0,0,7,16,17,7,0,0,2,3,2,0,0,0.191489361702128,0.404255319148936,0.404255319148936,0.851063829787234,0,0,0.175,0.4,0.425,0.148936170212766,0,0,0.285714285714286,0.428571428571429,0.285714285714286
"25005611202",2017,115,0,6,35,48,26,102,0,4,29,44,25,13,0,2,6,4,1,0,0.0521739130434783,0.304347826086957,0.417391304347826,0.226086956521739,0.88695652173913,0,0.0392156862745098,0.284313725490196,0.431372549019608,0.245098039215686,0.11304347826087,0,0.153846153846154,0.461538461538462,0.307692307692308,0.0769230769230769
"25005612100",2017,75,0,0,26,24,25,74,0,0,25,24,25,1,0,0,1,0,0,0,0,0.346666666666667,0.32,0.333333333333333,0.986666666666667,0,0,0.337837837837838,0.324324324324324,0.337837837837838,0.0133333333333333,0,0,1,0,0
"25005612200",2017,201,1,1,48,75,76,182,0,1,43,70,68,19,1,0,5,5,8,0.00497512437810945,0.00497512437810945,0.238805970149254,0.373134328358209,0.378109452736318,0.90547263681592,0,0.00549450549450549,0.236263736263736,0.384615384615385,0.373626373626374,0.0945273631840796,0.0526315789473684,0,0.263157894736842,0.263157894736842,0.421052631578947
"25005613100",2017,165,0,13,86,48,18,135,0,3,72,44,16,30,0,10,14,4,2,0,0.0787878787878788,0.521212121212121,0.290909090909091,0.109090909090909,0.818181818181818,0,0.0222222222222222,0.533333333333333,0.325925925925926,0.118518518518519,0.181818181818182,0,0.333333333333333,0.466666666666667,0.133333333333333,0.0666666666666667
"25005613300",2017,125,0,5,49,55,16,113,0,2,44,51,16,12,0,3,5,4,0,0,0.04,0.392,0.44,0.128,0.904,0,0.0176991150442478,0.389380530973451,0.451327433628319,0.141592920353982,0.096,0,0.25,0.416666666666667,0.333333333333333,0
"25005613400",2017,69,0,3,29,30,7,58,0,3,24,25,6,11,0,0,5,5,1,0,0.0434782608695652,0.420289855072464,0.434782608695652,0.101449275362319,0.840579710144927,0,0.0517241379310345,0.413793103448276,0.431034482758621,0.103448275862069,0.159420289855072,0,0,0.454545454545455,0.454545454545455,0.0909090909090909
"25005613600",2017,46,1,4,31,10,0,34,0,0,25,9,0,12,1,4,6,1,0,0.0217391304347826,0.0869565217391304,0.673913043478261,0.217391304347826,0,0.739130434782609,0,0,0.735294117647059,0.264705882352941,0,0.260869565217391,0.0833333333333333,0.333333333333333,0.5,0.0833333333333333,0
"25005613700",2017,62,0,1,38,21,2,52,0,0,33,17,2,10,0,1,5,4,0,0,0.0161290322580645,0.612903225806452,0.338709677419355,0.032258064516129,0.838709677419355,0,0,0.634615384615385,0.326923076923077,0.0384615384615385,0.161290322580645,0,0.1,0.5,0.4,0
"25005613800",2017,43,0,4,20,15,4,37,0,3,20,10,4,6,0,1,0,5,0,0,0.0930232558139535,0.465116279069767,0.348837209302326,0.0930232558139535,0.86046511627907,0,0.0810810810810811,0.540540540540541,0.27027027027027,0.108108108108108,0.13953488372093,0,0.166666666666667,0,0.833333333333333,0
"25005613901",2017,41,0,3,21,16,1,33,0,2,17,13,1,8,0,1,4,3,0,0,0.0731707317073171,0.51219512195122,0.390243902439024,0.024390243902439,0.804878048780488,0,0.0606060606060606,0.515151515151515,0.393939393939394,0.0303030303030303,0.195121951219512,0,0.125,0.5,0.375,0
"25005613902",2017,84,0,3,39,32,10,76,0,2,34,30,10,8,0,1,5,2,0,0,0.0357142857142857,0.464285714285714,0.380952380952381,0.119047619047619,0.904761904761905,0,0.0263157894736842,0.447368421052632,0.394736842105263,0.131578947368421,0.0952380952380952,0,0.125,0.625,0.25,0
"25005614000",2017,35,0,2,17,15,1,32,0,1,15,15,1,3,0,1,2,0,0,0,0.0571428571428571,0.485714285714286,0.428571428571429,0.0285714285714286,0.914285714285714,0,0.03125,0.46875,0.46875,0.03125,0.0857142857142857,0,0.333333333333333,0.666666666666667,0,0
"25005614101",2017,115,1,8,62,34,10,102,1,5,55,32,9,13,0,3,7,2,1,0.00869565217391304,0.0695652173913043,0.539130434782609,0.295652173913043,0.0869565217391304,0.88695652173913,0.00980392156862745,0.0490196078431373,0.53921568627451,0.313725490196078,0.0882352941176471,0.11304347826087,0,0.230769230769231,0.538461538461538,0.153846153846154,0.0769230769230769
"25005614102",2017,127,0,5,47,66,9,112,0,3,40,60,9,15,0,2,7,6,0,0,0.0393700787401575,0.37007874015748,0.519685039370079,0.0708661417322835,0.881889763779528,0,0.0267857142857143,0.357142857142857,0.535714285714286,0.0803571428571429,0.118110236220472,0,0.133333333333333,0.466666666666667,0.4,0
"25005615100",2017,145,0,2,41,59,43,129,0,1,31,56,41,16,0,1,10,3,2,0,0.0137931034482759,0.282758620689655,0.406896551724138,0.296551724137931,0.889655172413793,0,0.00775193798449612,0.24031007751938,0.434108527131783,0.317829457364341,0.110344827586207,0,0.0625,0.625,0.1875,0.125
"25005616100",2017,88,0,0,22,41,25,76,0,0,16,38,22,12,0,0,6,3,3,0,0,0.25,0.465909090909091,0.284090909090909,0.863636363636364,0,0,0.210526315789474,0.5,0.289473684210526,0.136363636363636,0,0,0.5,0.25,0.25
"25005617101",2017,74,0,2,20,32,20,65,0,1,16,29,19,9,0,1,4,3,1,0,0.027027027027027,0.27027027027027,0.432432432432432,0.27027027027027,0.878378378378378,0,0.0153846153846154,0.246153846153846,0.446153846153846,0.292307692307692,0.121621621621622,0,0.111111111111111,0.444444444444444,0.333333333333333,0.111111111111111
"25005617102",2017,55,0,0,19,28,8,50,0,0,18,24,8,5,0,0,1,4,0,0,0,0.345454545454545,0.509090909090909,0.145454545454545,0.909090909090909,0,0,0.36,0.48,0.16,0.0909090909090909,0,0,0.2,0.8,0
"25005630101",2017,37,0,2,17,9,9,31,0,2,12,8,9,6,0,0,5,1,0,0,0.0540540540540541,0.459459459459459,0.243243243243243,0.243243243243243,0.837837837837838,0,0.0645161290322581,0.387096774193548,0.258064516129032,0.290322580645161,0.162162162162162,0,0,0.833333333333333,0.166666666666667,0
"25005630102",2017,86,0,3,47,28,8,73,0,2,38,26,7,13,0,1,9,2,1,0,0.0348837209302326,0.546511627906977,0.325581395348837,0.0930232558139535,0.848837209302326,0,0.0273972602739726,0.520547945205479,0.356164383561644,0.0958904109589041,0.151162790697674,0,0.0769230769230769,0.692307692307692,0.153846153846154,0.0769230769230769
"25005630200",2017,135,0,1,28,54,52,129,0,1,25,52,51,6,0,0,3,2,1,0,0.00740740740740741,0.207407407407407,0.4,0.385185185185185,0.955555555555556,0,0.00775193798449612,0.193798449612403,0.403100775193798,0.395348837209302,0.0444444444444444,0,0,0.5,0.333333333333333,0.166666666666667
"25005630300",2017,144,0,2,38,54,50,133,0,0,34,52,47,11,0,2,4,2,3,0,0.0138888888888889,0.263888888888889,0.375,0.347222222222222,0.923611111111111,0,0,0.255639097744361,0.390977443609023,0.353383458646617,0.0763888888888889,0,0.181818181818182,0.363636363636364,0.181818181818182,0.272727272727273
"25005630400",2017,57,0,2,17,20,18,54,0,2,15,20,17,3,0,0,2,0,1,0,0.0350877192982456,0.298245614035088,0.350877192982456,0.315789473684211,0.947368421052632,0,0.037037037037037,0.277777777777778,0.37037037037037,0.314814814814815,0.0526315789473684,0,0,0.666666666666667,0,0.333333333333333
"25005631100",2017,124,0,3,64,41,16,103,0,2,57,33,11,21,0,1,7,8,5,0,0.0241935483870968,0.516129032258065,0.330645161290323,0.129032258064516,0.830645161290323,0,0.0194174757281553,0.553398058252427,0.320388349514563,0.106796116504854,0.169354838709677,0,0.0476190476190476,0.333333333333333,0.380952380952381,0.238095238095238
"25005631200",2017,116,0,2,32,47,35,110,0,0,29,46,35,6,0,2,3,1,0,0,0.0172413793103448,0.275862068965517,0.405172413793103,0.301724137931034,0.948275862068966,0,0,0.263636363636364,0.418181818181818,0.318181818181818,0.0517241379310345,0,0.333333333333333,0.5,0.166666666666667,0
"25005631300",2017,90,0,0,33,33,24,88,0,0,33,32,23,2,0,0,0,1,1,0,0,0.366666666666667,0.366666666666667,0.266666666666667,0.977777777777778,0,0,0.375,0.363636363636364,0.261363636363636,0.0222222222222222,0,0,0,0.5,0.5
"25005631400",2017,21,0,2,10,8,1,18,0,1,8,8,1,3,0,1,2,0,0,0,0.0952380952380952,0.476190476190476,0.380952380952381,0.0476190476190476,0.857142857142857,0,0.0555555555555556,0.444444444444444,0.444444444444444,0.0555555555555556,0.142857142857143,0,0.333333333333333,0.666666666666667,0,0
"25005631500",2017,41,1,2,21,8,9,32,0,0,17,8,7,9,1,2,4,0,2,0.024390243902439,0.0487804878048781,0.51219512195122,0.195121951219512,0.219512195121951,0.780487804878049,0,0,0.53125,0.25,0.21875,0.219512195121951,0.111111111111111,0.222222222222222,0.444444444444444,0,0.222222222222222
"25005631600",2017,54,0,1,27,13,13,49,0,1,24,12,12,5,0,0,3,1,1,0,0.0185185185185185,0.5,0.240740740740741,0.240740740740741,0.907407407407407,0,0.0204081632653061,0.489795918367347,0.244897959183673,0.244897959183673,0.0925925925925926,0,0,0.6,0.2,0.2
"25005631700",2017,120,0,0,37,54,29,113,0,0,33,52,28,7,0,0,4,2,1,0,0,0.308333333333333,0.45,0.241666666666667,0.941666666666667,0,0,0.292035398230089,0.460176991150442,0.247787610619469,0.0583333333333333,0,0,0.571428571428571,0.285714285714286,0.142857142857143
"25005631800",2017,118,0,5,53,36,24,105,0,3,44,34,24,13,0,2,9,2,0,0,0.0423728813559322,0.449152542372881,0.305084745762712,0.203389830508475,0.889830508474576,0,0.0285714285714286,0.419047619047619,0.323809523809524,0.228571428571429,0.110169491525424,0,0.153846153846154,0.692307692307692,0.153846153846154,0
"25005632100",2017,92,0,1,24,42,25,87,0,1,24,37,25,5,0,0,0,5,0,0,0.0108695652173913,0.260869565217391,0.456521739130435,0.271739130434783,0.945652173913043,0,0.0114942528735632,0.275862068965517,0.425287356321839,0.28735632183908,0.0543478260869565,0,0,0,1,0
"25005632200",2017,112,1,1,29,45,36,105,0,1,26,42,36,7,1,0,3,3,0,0.00892857142857143,0.00892857142857143,0.258928571428571,0.401785714285714,0.321428571428571,0.9375,0,0.00952380952380952,0.247619047619048,0.4,0.342857142857143,0.0625,0.142857142857143,0,0.428571428571429,0.428571428571429,0
"25005633100",2017,78,0,0,10,38,30,72,0,0,10,34,28,6,0,0,0,4,2,0,0,0.128205128205128,0.487179487179487,0.384615384615385,0.923076923076923,0,0,0.138888888888889,0.472222222222222,0.388888888888889,0.0769230769230769,0,0,0,0.666666666666667,0.333333333333333
"25005633200",2017,76,0,1,14,25,36,75,0,1,14,24,36,1,0,0,0,1,0,0,0.0131578947368421,0.184210526315789,0.328947368421053,0.473684210526316,0.986842105263158,0,0.0133333333333333,0.186666666666667,0.32,0.48,0.0131578947368421,0,0,0,1,0
"25005640100",2017,57,0,3,32,16,6,48,0,1,30,12,5,9,0,2,2,4,1,0,0.0526315789473684,0.56140350877193,0.280701754385965,0.105263157894737,0.842105263157895,0,0.0208333333333333,0.625,0.25,0.104166666666667,0.157894736842105,0,0.222222222222222,0.222222222222222,0.444444444444444,0.111111111111111
"25005640200",2017,49,0,3,33,11,2,41,0,1,28,11,1,8,0,2,5,0,1,0,0.0612244897959184,0.673469387755102,0.224489795918367,0.0408163265306122,0.836734693877551,0,0.024390243902439,0.682926829268293,0.268292682926829,0.024390243902439,0.163265306122449,0,0.25,0.625,0,0.125
"25005640300",2017,38,0,3,18,14,3,33,0,2,17,11,3,5,0,1,1,3,0,0,0.0789473684210526,0.473684210526316,0.368421052631579,0.0789473684210526,0.868421052631579,0,0.0606060606060606,0.515151515151515,0.333333333333333,0.0909090909090909,0.131578947368421,0,0.2,0.2,0.6,0
"25005640400",2017,29,1,2,18,5,3,25,0,1,16,5,3,4,1,1,2,0,0,0.0344827586206897,0.0689655172413793,0.620689655172414,0.172413793103448,0.103448275862069,0.862068965517241,0,0.04,0.64,0.2,0.12,0.137931034482759,0.25,0.25,0.5,0,0
"25005640500",2017,57,0,7,30,13,7,46,0,5,29,9,3,11,0,2,1,4,4,0,0.12280701754386,0.526315789473684,0.228070175438596,0.12280701754386,0.807017543859649,0,0.108695652173913,0.630434782608696,0.195652173913043,0.0652173913043478,0.192982456140351,0,0.181818181818182,0.0909090909090909,0.363636363636364,0.363636363636364
"25005640600",2017,35,0,5,22,6,2,23,0,3,15,4,1,12,0,2,7,2,1,0,0.142857142857143,0.628571428571429,0.171428571428571,0.0571428571428571,0.657142857142857,0,0.130434782608696,0.652173913043478,0.173913043478261,0.0434782608695652,0.342857142857143,0,0.166666666666667,0.583333333333333,0.166666666666667,0.0833333333333333
"25005640700",2017,37,0,4,24,9,0,34,0,3,22,9,0,3,0,1,2,0,0,0,0.108108108108108,0.648648648648649,0.243243243243243,0,0.918918918918919,0,0.0882352941176471,0.647058823529412,0.264705882352941,0,0.0810810810810811,0,0.333333333333333,0.666666666666667,0,0
"25005640800",2017,48,0,1,33,13,1,40,0,1,28,10,1,8,0,0,5,3,0,0,0.0208333333333333,0.6875,0.270833333333333,0.0208333333333333,0.833333333333333,0,0.025,0.7,0.25,0.025,0.166666666666667,0,0,0.625,0.375,0
"25005640901",2017,34,0,2,22,9,1,28,0,2,17,8,1,6,0,0,5,1,0,0,0.0588235294117647,0.647058823529412,0.264705882352941,0.0294117647058824,0.823529411764706,0,0.0714285714285714,0.607142857142857,0.285714285714286,0.0357142857142857,0.176470588235294,0,0,0.833333333333333,0.166666666666667,0
"25005641000",2017,4,0,0,4,0,0,4,0,0,4,0,0,0,0,0,0,0,0,0,0,1,0,0,1,0,0,1,0,0,0,0,0,0,0,0
"25005641101",2017,4,0,1,2,1,0,4,0,1,2,1,0,0,0,0,0,0,0,0,0.25,0.5,0.25,0,1,0,0.25,0.5,0.25,0,0,0,0,0,0,0
"25005641200",2017,6,0,2,3,0,1,6,0,2,3,0,1,0,0,0,0,0,0,0,0.333333333333333,0.5,0,0.166666666666667,1,0,0.333333333333333,0.5,0,0.166666666666667,0,0,0,0,0,0
"25005641300",2017,31,0,5,16,8,2,23,0,3,12,6,2,8,0,2,4,2,0,0,0.161290322580645,0.516129032258065,0.258064516129032,0.0645161290322581,0.741935483870968,0,0.130434782608696,0.521739130434783,0.260869565217391,0.0869565217391304,0.258064516129032,0,0.25,0.5,0.25,0
"25005641400",2017,14,1,0,10,2,1,12,0,0,9,2,1,2,1,0,1,0,0,0.0714285714285714,0,0.714285714285714,0.142857142857143,0.0714285714285714,0.857142857142857,0,0,0.75,0.166666666666667,0.0833333333333333,0.142857142857143,0.5,0,0.5,0,0
"25005641500",2017,17,0,1,11,2,3,16,0,1,11,2,2,1,0,0,0,0,1,0,0.0588235294117647,0.647058823529412,0.117647058823529,0.176470588235294,0.941176470588235,0,0.0625,0.6875,0.125,0.125,0.0588235294117647,0,0,0,0,1
"25005641600",2017,20,0,2,11,5,2,19,0,2,11,4,2,1,0,0,0,1,0,0,0.1,0.55,0.25,0.1,0.95,0,0.105263157894737,0.578947368421053,0.210526315789474,0.105263157894737,0.05,0,0,0,1,0
"25005641700",2017,48,0,3,32,12,1,41,0,3,26,11,1,7,0,0,6,1,0,0,0.0625,0.666666666666667,0.25,0.0208333333333333,0.854166666666667,0,0.0731707317073171,0.634146341463415,0.268292682926829,0.024390243902439,0.145833333333333,0,0,0.857142857142857,0.142857142857143,0
"25005641800",2017,18,0,1,11,4,2,16,0,0,10,4,2,2,0,1,1,0,0,0,0.0555555555555556,0.611111111111111,0.222222222222222,0.111111111111111,0.888888888888889,0,0,0.625,0.25,0.125,0.111111111111111,0,0.5,0.5,0,0
"25005641900",2017,8,0,0,7,1,0,7,0,0,6,1,0,1,0,0,1,0,0,0,0,0.875,0.125,0,0.875,0,0,0.857142857142857,0.142857142857143,0,0.125,0,0,1,0,0
"25005642000",2017,22,0,1,17,4,0,18,0,1,14,3,0,4,0,0,3,1,0,0,0.0454545454545455,0.772727272727273,0.181818181818182,0,0.818181818181818,0,0.0555555555555556,0.777777777777778,0.166666666666667,0,0.181818181818182,0,0,0.75,0.25,0
"25005642100",2017,26,0,2,14,8,2,24,0,2,12,8,2,2,0,0,2,0,0,0,0.0769230769230769,0.538461538461538,0.307692307692308,0.0769230769230769,0.923076923076923,0,0.0833333333333333,0.5,0.333333333333333,0.0833333333333333,0.0769230769230769,0,0,1,0,0
"25005642200",2017,45,0,1,32,9,3,40,0,1,27,9,3,5,0,0,5,0,0,0,0.0222222222222222,0.711111111111111,0.2,0.0666666666666667,0.888888888888889,0,0.025,0.675,0.225,0.075,0.111111111111111,0,0,1,0,0
"25005642300",2017,38,0,0,22,13,3,32,0,0,17,12,3,6,0,0,5,1,0,0,0,0.578947368421053,0.342105263157895,0.0789473684210526,0.842105263157895,0,0,0.53125,0.375,0.09375,0.157894736842105,0,0,0.833333333333333,0.166666666666667,0
"25005642400",2017,29,0,0,17,10,2,27,0,0,16,9,2,2,0,0,1,1,0,0,0,0.586206896551724,0.344827586206897,0.0689655172413793,0.931034482758621,0,0,0.592592592592593,0.333333333333333,0.0740740740740741,0.0689655172413793,0,0,0.5,0.5,0
"25005642500",2017,73,0,7,43,17,6,62,0,3,39,14,6,11,0,4,4,3,0,0,0.0958904109589041,0.589041095890411,0.232876712328767,0.0821917808219178,0.849315068493151,0,0.0483870967741935,0.629032258064516,0.225806451612903,0.0967741935483871,0.150684931506849,0,0.363636363636364,0.363636363636364,0.272727272727273,0
"25005644101",2017,92,0,1,49,30,12,83,0,1,44,26,12,9,0,0,5,4,0,0,0.0108695652173913,0.532608695652174,0.326086956521739,0.130434782608696,0.902173913043478,0,0.0120481927710843,0.530120481927711,0.313253012048193,0.144578313253012,0.0978260869565217,0,0,0.555555555555556,0.444444444444444,0
"25005644102",2017,62,0,1,20,26,15,59,0,1,17,26,15,3,0,0,3,0,0,0,0.0161290322580645,0.32258064516129,0.419354838709677,0.241935483870968,0.951612903225806,0,0.0169491525423729,0.288135593220339,0.440677966101695,0.254237288135593,0.0483870967741935,0,0,1,0,0
"25005644200",2017,126,0,1,60,50,15,117,0,0,55,47,15,9,0,1,5,3,0,0,0.00793650793650794,0.476190476190476,0.396825396825397,0.119047619047619,0.928571428571429,0,0,0.47008547008547,0.401709401709402,0.128205128205128,0.0714285714285714,0,0.111111111111111,0.555555555555556,0.333333333333333,0
"25005645101",2017,97,0,4,37,35,21,86,0,4,30,32,20,11,0,0,7,3,1,0,0.0412371134020619,0.381443298969072,0.360824742268041,0.216494845360825,0.88659793814433,0,0.0465116279069767,0.348837209302326,0.372093023255814,0.232558139534884,0.11340206185567,0,0,0.636363636363636,0.272727272727273,0.0909090909090909
"25005645102",2017,104,0,2,25,49,28,93,0,1,22,44,26,11,0,1,3,5,2,0,0.0192307692307692,0.240384615384615,0.471153846153846,0.269230769230769,0.894230769230769,0,0.010752688172043,0.236559139784946,0.473118279569892,0.279569892473118,0.105769230769231,0,0.0909090909090909,0.272727272727273,0.454545454545455,0.181818181818182
"25005645103",2017,72,0,3,30,28,11,62,0,0,27,25,10,10,0,3,3,3,1,0,0.0416666666666667,0.416666666666667,0.388888888888889,0.152777777777778,0.861111111111111,0,0,0.435483870967742,0.403225806451613,0.161290322580645,0.138888888888889,0,0.3,0.3,0.3,0.1
"25005646101",2017,103,0,1,37,49,16,95,0,0,34,47,14,8,0,1,3,2,2,0,0.00970873786407767,0.359223300970874,0.475728155339806,0.155339805825243,0.922330097087379,0,0,0.357894736842105,0.494736842105263,0.147368421052632,0.0776699029126214,0,0.125,0.375,0.25,0.25
"25005646103",2017,65,0,0,10,25,30,59,0,0,10,22,27,6,0,0,0,3,3,0,0,0.153846153846154,0.384615384615385,0.461538461538462,0.907692307692308,0,0,0.169491525423729,0.372881355932203,0.457627118644068,0.0923076923076923,0,0,0,0.5,0.5
"25005646104",2017,42,0,0,3,9,30,41,0,0,3,8,30,1,0,0,0,1,0,0,0,0.0714285714285714,0.214285714285714,0.714285714285714,0.976190476190476,0,0,0.0731707317073171,0.195121951219512,0.731707317073171,0.0238095238095238,0,0,0,1,0
"25005650101",2017,101,1,0,63,34,3,86,0,0,52,31,3,15,1,0,11,3,0,0.0099009900990099,0,0.623762376237624,0.336633663366337,0.0297029702970297,0.851485148514851,0,0,0.604651162790698,0.36046511627907,0.0348837209302326,0.148514851485149,0.0666666666666667,0,0.733333333333333,0.2,0
"25005650102",2017,71,0,8,41,20,2,62,0,4,37,19,2,9,0,4,4,1,0,0,0.112676056338028,0.577464788732394,0.28169014084507,0.028169014084507,0.873239436619718,0,0.0645161290322581,0.596774193548387,0.306451612903226,0.032258064516129,0.126760563380282,0,0.444444444444444,0.444444444444444,0.111111111111111,0
"25005650201",2017,56,0,1,35,18,2,51,0,1,31,18,1,5,0,0,4,0,1,0,0.0178571428571429,0.625,0.321428571428571,0.0357142857142857,0.910714285714286,0,0.0196078431372549,0.607843137254902,0.352941176470588,0.0196078431372549,0.0892857142857143,0,0,0.8,0,0.2
"25005650202",2017,33,0,0,27,5,1,31,0,0,25,5,1,2,0,0,2,0,0,0,0,0.818181818181818,0.151515151515152,0.0303030303030303,0.939393939393939,0,0,0.806451612903226,0.161290322580645,0.032258064516129,0.0606060606060606,0,0,1,0,0
"25005650300",2017,42,0,2,29,10,1,39,0,1,28,9,1,3,0,1,1,1,0,0,0.0476190476190476,0.69047619047619,0.238095238095238,0.0238095238095238,0.928571428571429,0,0.0256410256410256,0.717948717948718,0.230769230769231,0.0256410256410256,0.0714285714285714,0,0.333333333333333,0.333333333333333,0.333333333333333,0
"25005650400",2017,38,0,2,29,5,2,32,0,1,25,4,2,6,0,1,4,1,0,0,0.0526315789473684,0.763157894736842,0.131578947368421,0.0526315789473684,0.842105263157895,0,0.03125,0.78125,0.125,0.0625,0.157894736842105,0,0.166666666666667,0.666666666666667,0.166666666666667,0
"25005650500",2017,29,0,0,20,9,0,28,0,0,19,9,0,1,0,0,1,0,0,0,0,0.689655172413793,0.310344827586207,0,0.96551724137931,0,0,0.678571428571429,0.321428571428571,0,0.0344827586206897,0,0,1,0,0
"25005650600",2017,8,0,0,8,0,0,6,0,0,6,0,0,2,0,0,2,0,0,0,0,1,0,0,0.75,0,0,1,0,0,0.25,0,0,1,0,0
"25005650700",2017,9,0,0,5,3,1,9,0,0,5,3,1,0,0,0,0,0,0,0,0,0.555555555555556,0.333333333333333,0.111111111111111,1,0,0,0.555555555555556,0.333333333333333,0.111111111111111,0,0,0,0,0,0
"25005650800",2017,23,0,1,19,2,1,19,0,1,15,2,1,4,0,0,4,0,0,0,0.0434782608695652,0.826086956521739,0.0869565217391304,0.0434782608695652,0.826086956521739,0,0.0526315789473684,0.789473684210526,0.105263157894737,0.0526315789473684,0.173913043478261,0,0,1,0,0
"25005650900",2017,19,0,0,15,4,0,15,0,0,11,4,0,4,0,0,4,0,0,0,0,0.789473684210526,0.210526315789474,0,0.789473684210526,0,0,0.733333333333333,0.266666666666667,0,0.210526315789474,0,0,1,0,0
"25005651001",2017,25,0,1,14,8,2,21,0,0,11,8,2,4,0,1,3,0,0,0,0.04,0.56,0.32,0.08,0.84,0,0,0.523809523809524,0.380952380952381,0.0952380952380952,0.16,0,0.25,0.75,0,0
"25005651002",2017,59,0,5,28,23,3,51,0,3,24,21,3,8,0,2,4,2,0,0,0.0847457627118644,0.474576271186441,0.389830508474576,0.0508474576271186,0.864406779661017,0,0.0588235294117647,0.470588235294118,0.411764705882353,0.0588235294117647,0.135593220338983,0,0.25,0.5,0.25,0
"25005651100",2017,44,0,8,27,9,0,38,0,4,25,9,0,6,0,4,2,0,0,0,0.181818181818182,0.613636363636364,0.204545454545455,0,0.863636363636364,0,0.105263157894737,0.657894736842105,0.236842105263158,0,0.136363636363636,0,0.666666666666667,0.333333333333333,0,0
"25005651200",2017,12,0,4,6,1,1,11,0,3,6,1,1,1,0,1,0,0,0,0,0.333333333333333,0.5,0.0833333333333333,0.0833333333333333,0.916666666666667,0,0.272727272727273,0.545454545454545,0.0909090909090909,0.0909090909090909,0.0833333333333333,0,1,0,0,0
"25005651300",2017,15,0,0,9,5,1,10,0,0,6,4,0,5,0,0,3,1,1,0,0,0.6,0.333333333333333,0.0666666666666667,0.666666666666667,0,0,0.6,0.4,0,0.333333333333333,0,0,0.6,0.2,0.2
"25005651400",2017,50,0,13,29,5,3,35,0,6,25,3,1,15,0,7,4,2,2,0,0.26,0.58,0.1,0.06,0.7,0,0.171428571428571,0.714285714285714,0.0857142857142857,0.0285714285714286,0.3,0,0.466666666666667,0.266666666666667,0.133333333333333,0.133333333333333
"25005651500",2017,42,0,5,26,10,1,35,0,3,22,9,1,7,0,2,4,1,0,0,0.119047619047619,0.619047619047619,0.238095238095238,0.0238095238095238,0.833333333333333,0,0.0857142857142857,0.628571428571429,0.257142857142857,0.0285714285714286,0.166666666666667,0,0.285714285714286,0.571428571428571,0.142857142857143,0
"25005651600",2017,56,0,7,35,11,3,52,0,7,31,11,3,4,0,0,4,0,0,0,0.125,0.625,0.196428571428571,0.0535714285714286,0.928571428571429,0,0.134615384615385,0.596153846153846,0.211538461538462,0.0576923076923077,0.0714285714285714,0,0,1,0,0
"25005651700",2017,16,0,1,10,3,2,12,0,1,7,3,1,4,0,0,3,0,1,0,0.0625,0.625,0.1875,0.125,0.75,0,0.0833333333333333,0.583333333333333,0.25,0.0833333333333333,0.25,0,0,0.75,0,0.25
"25005651800",2017,8,0,0,2,5,1,7,0,0,2,4,1,1,0,0,0,1,0,0,0,0.25,0.625,0.125,0.875,0,0,0.285714285714286,0.571428571428571,0.142857142857143,0.125,0,0,0,1,0
"25005651900",2017,6,0,0,4,2,0,6,0,0,4,2,0,0,0,0,0,0,0,0,0,0.666666666666667,0.333333333333333,0,1,0,0,0.666666666666667,0.333333333333333,0,0,0,0,0,0,0
"25005652000",2017,30,0,5,18,5,2,21,0,3,11,5,2,9,0,2,7,0,0,0,0.166666666666667,0.6,0.166666666666667,0.0666666666666667,0.7,0,0.142857142857143,0.523809523809524,0.238095238095238,0.0952380952380952,0.3,0,0.222222222222222,0.777777777777778,0,0
"25005652100",2017,40,0,3,28,8,1,35,0,3,23,8,1,5,0,0,5,0,0,0,0.075,0.7,0.2,0.025,0.875,0,0.0857142857142857,0.657142857142857,0.228571428571429,0.0285714285714286,0.125,0,0,1,0,0
"25005652200",2017,35,1,1,23,8,2,35,1,1,23,8,2,0,0,0,0,0,0,0.0285714285714286,0.0285714285714286,0.657142857142857,0.228571428571429,0.0571428571428571,1,0.0285714285714286,0.0285714285714286,0.657142857142857,0.228571428571429,0.0571428571428571,0,0,0,0,0,0
"25005652300",2017,30,0,3,21,5,1,25,0,3,17,4,1,5,0,0,4,1,0,0,0.1,0.7,0.166666666666667,0.0333333333333333,0.833333333333333,0,0.12,0.68,0.16,0.04,0.166666666666667,0,0,0.8,0.2,0
"25005652400",2017,30,0,1,22,6,1,24,0,1,16,6,1,6,0,0,6,0,0,0,0.0333333333333333,0.733333333333333,0.2,0.0333333333333333,0.8,0,0.0416666666666667,0.666666666666667,0.25,0.0416666666666667,0.2,0,0,1,0,0
"25005652500",2017,22,1,1,15,4,1,14,0,0,11,2,1,8,1,1,4,2,0,0.0454545454545455,0.0454545454545455,0.681818181818182,0.181818181818182,0.0454545454545455,0.636363636363636,0,0,0.785714285714286,0.142857142857143,0.0714285714285714,0.363636363636364,0.125,0.125,0.5,0.25,0
"25005652600",2017,22,0,2,15,4,1,16,0,1,10,4,1,6,0,1,5,0,0,0,0.0909090909090909,0.681818181818182,0.181818181818182,0.0454545454545455,0.727272727272727,0,0.0625,0.625,0.25,0.0625,0.272727272727273,0,0.166666666666667,0.833333333333333,0,0
"25005652700",2017,30,0,1,20,8,1,28,0,1,18,8,1,2,0,0,2,0,0,0,0.0333333333333333,0.666666666666667,0.266666666666667,0.0333333333333333,0.933333333333333,0,0.0357142857142857,0.642857142857143,0.285714285714286,0.0357142857142857,0.0666666666666667,0,0,1,0,0
"25005652800",2017,41,1,1,21,14,4,38,0,1,19,14,4,3,1,0,2,0,0,0.024390243902439,0.024390243902439,0.51219512195122,0.341463414634146,0.0975609756097561,0.926829268292683,0,0.0263157894736842,0.5,0.368421052631579,0.105263157894737,0.0731707317073171,0.333333333333333,0,0.666666666666667,0,0
"25005653101",2017,91,0,2,30,51,8,85,0,1,26,50,8,6,0,1,4,1,0,0,0.021978021978022,0.32967032967033,0.56043956043956,0.0879120879120879,0.934065934065934,0,0.0117647058823529,0.305882352941176,0.588235294117647,0.0941176470588235,0.0659340659340659,0,0.166666666666667,0.666666666666667,0.166666666666667,0
"25005653102",2017,63,0,0,16,26,21,56,0,0,13,24,19,7,0,0,3,2,2,0,0,0.253968253968254,0.412698412698413,0.333333333333333,0.888888888888889,0,0,0.232142857142857,0.428571428571429,0.339285714285714,0.111111111111111,0,0,0.428571428571429,0.285714285714286,0.285714285714286
"25005653203",2017,65,0,1,30,27,7,62,0,0,28,27,7,3,0,1,2,0,0,0,0.0153846153846154,0.461538461538462,0.415384615384615,0.107692307692308,0.953846153846154,0,0,0.451612903225806,0.435483870967742,0.112903225806452,0.0461538461538462,0,0.333333333333333,0.666666666666667,0,0
"25005653204",2017,47,0,0,16,21,10,45,0,0,15,20,10,2,0,0,1,1,0,0,0,0.340425531914894,0.446808510638298,0.212765957446809,0.957446808510638,0,0,0.333333333333333,0.444444444444444,0.222222222222222,0.0425531914893617,0,0,0.5,0.5,0
"25005653301",2017,67,1,2,12,17,35,62,1,1,9,16,35,5,0,1,3,1,0,0.0149253731343284,0.0298507462686567,0.17910447761194,0.253731343283582,0.522388059701492,0.925373134328358,0.0161290322580645,0.0161290322580645,0.145161290322581,0.258064516129032,0.564516129032258,0.0746268656716418,0,0.2,0.6,0.2,0
"25005653304",2017,47,0,0,8,9,30,44,0,0,8,8,28,3,0,0,0,1,2,0,0,0.170212765957447,0.191489361702128,0.638297872340426,0.936170212765957,0,0,0.181818181818182,0.181818181818182,0.636363636363636,0.0638297872340425,0,0,0,0.333333333333333,0.666666666666667
"25005654100",2017,94,0,2,33,37,22,88,0,0,30,37,21,6,0,2,3,0,1,0,0.0212765957446809,0.351063829787234,0.393617021276596,0.234042553191489,0.936170212765957,0,0,0.340909090909091,0.420454545454545,0.238636363636364,0.0638297872340425,0,0.333333333333333,0.5,0,0.166666666666667
"25005654200",2017,37,0,1,21,13,2,34,0,0,20,12,2,3,0,1,1,1,0,0,0.027027027027027,0.567567567567568,0.351351351351351,0.0540540540540541,0.918918918918919,0,0,0.588235294117647,0.352941176470588,0.0588235294117647,0.0810810810810811,0,0.333333333333333,0.333333333333333,0.333333333333333,0
"25005655100",2017,69,0,1,29,31,8,61,0,1,25,28,7,8,0,0,4,3,1,0,0.0144927536231884,0.420289855072464,0.449275362318841,0.115942028985507,0.884057971014493,0,0.0163934426229508,0.409836065573771,0.459016393442623,0.114754098360656,0.115942028985507,0,0,0.5,0.375,0.125
"25005655200",2017,57,0,3,38,13,3,52,0,2,34,13,3,5,0,1,4,0,0,0,0.0526315789473684,0.666666666666667,0.228070175438596,0.0526315789473684,0.912280701754386,0,0.0384615384615385,0.653846153846154,0.25,0.0576923076923077,0.087719298245614,0,0.2,0.8,0,0
"25005655300",2017,37,0,2,17,16,2,31,0,2,12,15,2,6,0,0,5,1,0,0,0.0540540540540541,0.459459459459459,0.432432432432432,0.0540540540540541,0.837837837837838,0,0.0645161290322581,0.387096774193548,0.483870967741935,0.0645161290322581,0.162162162162162,0,0,0.833333333333333,0.166666666666667,0
"25005655400",2017,68,1,2,22,17,26,61,0,1,21,16,23,7,1,1,1,1,3,0.0147058823529412,0.0294117647058824,0.323529411764706,0.25,0.382352941176471,0.897058823529412,0,0.0163934426229508,0.344262295081967,0.262295081967213,0.377049180327869,0.102941176470588,0.142857142857143,0.142857142857143,0.142857142857143,0.142857142857143,0.428571428571429
"25005985500",2017,16,0,0,2,11,3,16,0,0,2,11,3,0,0,0,0,0,0,0,0,0.125,0.6875,0.1875,1,0,0,0.125,0.6875,0.1875,0,0,0,0,0,0
"25005985600",2017,42,0,0,4,13,25,40,0,0,4,13,23,2,0,0,0,0,2,0,0,0.0952380952380952,0.30952380952381,0.595238095238095,0.952380952380952,0,0,0.1,0.325,0.575,0.0476190476190476,0,0,0,0,1
"25007200100",2017,78,0,0,12,20,46,70,0,0,9,18,43,8,0,0,3,2,3,0,0,0.153846153846154,0.256410256410256,0.58974358974359,0.897435897435897,0,0,0.128571428571429,0.257142857142857,0.614285714285714,0.102564102564103,0,0,0.375,0.25,0.375
"25007200200",2017,92,0,1,7,24,60,83,0,1,5,20,57,9,0,0,2,4,3,0,0.0108695652173913,0.0760869565217391,0.260869565217391,0.652173913043478,0.902173913043478,0,0.0120481927710843,0.0602409638554217,0.240963855421687,0.686746987951807,0.0978260869565217,0,0,0.222222222222222,0.444444444444444,0.333333333333333
"25007200300",2017,104,0,0,4,11,89,95,0,0,2,11,82,9,0,0,2,0,7,0,0,0.0384615384615385,0.105769230769231,0.855769230769231,0.913461538461538,0,0,0.0210526315789474,0.115789473684211,0.863157894736842,0.0865384615384615,0,0,0.222222222222222,0,0.777777777777778
"25007200400",2017,74,0,0,0,11,63,71,0,0,0,11,60,3,0,0,0,0,3,0,0,0,0.148648648648649,0.851351351351351,0.959459459459459,0,0,0,0.154929577464789,0.845070422535211,0.0405405405405405,0,0,0,0,1
"25009201100",2017,51,0,0,5,17,29,47,0,0,4,15,28,4,0,0,1,2,1,0,0,0.0980392156862745,0.333333333333333,0.568627450980392,0.92156862745098,0,0,0.0851063829787234,0.319148936170213,0.595744680851064,0.0784313725490196,0,0,0.25,0.5,0.25
"25009202101",2017,33,0,0,4,12,17,29,0,0,2,10,17,4,0,0,2,2,0,0,0,0.121212121212121,0.363636363636364,0.515151515151515,0.878787878787879,0,0,0.0689655172413793,0.344827586206897,0.586206896551724,0.121212121212121,0,0,0.5,0.5,0
"25009202102",2017,94,0,0,25,32,37,85,0,0,22,27,36,9,0,0,3,5,1,0,0,0.265957446808511,0.340425531914894,0.393617021276596,0.904255319148936,0,0,0.258823529411765,0.317647058823529,0.423529411764706,0.0957446808510638,0,0,0.333333333333333,0.555555555555556,0.111111111111111
"25009202200",2017,95,0,0,2,18,75,87,0,0,1,17,69,8,0,0,1,1,6,0,0,0.0210526315789474,0.189473684210526,0.789473684210526,0.91578947368421,0,0,0.0114942528735632,0.195402298850575,0.793103448275862,0.0842105263157895,0,0,0.125,0.125,0.75
"25009203100",2017,93,0,0,6,24,63,92,0,0,5,24,63,1,0,0,1,0,0,0,0,0.0645161290322581,0.258064516129032,0.67741935483871,0.989247311827957,0,0,0.0543478260869565,0.260869565217391,0.684782608695652,0.010752688172043,0,0,1,0,0
"25009203200",2017,78,0,1,0,20,57,75,0,1,0,17,57,3,0,0,0,3,0,0,0.0128205128205128,0,0.256410256410256,0.730769230769231,0.961538461538462,0,0.0133333333333333,0,0.226666666666667,0.76,0.0384615384615385,0,0,0,1,0
"25009203301",2017,57,0,0,8,8,41,55,0,0,7,8,40,2,0,0,1,0,1,0,0,0.140350877192982,0.140350877192982,0.719298245614035,0.964912280701754,0,0,0.127272727272727,0.145454545454545,0.727272727272727,0.0350877192982456,0,0,0.5,0,0.5
"25009203302",2017,56,0,2,6,9,39,53,0,2,6,8,37,3,0,0,0,1,2,0,0.0357142857142857,0.107142857142857,0.160714285714286,0.696428571428571,0.946428571428571,0,0.0377358490566038,0.113207547169811,0.150943396226415,0.69811320754717,0.0535714285714286,0,0,0,0.333333333333333,0.666666666666667
"25009204101",2017,76,1,0,17,32,26,75,1,0,17,31,26,1,0,0,0,1,0,0.0131578947368421,0,0.223684210526316,0.421052631578947,0.342105263157895,0.986842105263158,0.0133333333333333,0,0.226666666666667,0.413333333333333,0.346666666666667,0.0131578947368421,0,0,0,1,0
"25009204102",2017,63,0,0,23,27,13,60,0,0,22,25,13,3,0,0,1,2,0,0,0,0.365079365079365,0.428571428571429,0.206349206349206,0.952380952380952,0,0,0.366666666666667,0.416666666666667,0.216666666666667,0.0476190476190476,0,0,0.333333333333333,0.666666666666667,0
"25009204200",2017,79,0,0,23,34,22,73,0,0,20,31,22,6,0,0,3,3,0,0,0,0.291139240506329,0.430379746835443,0.278481012658228,0.924050632911392,0,0,0.273972602739726,0.424657534246575,0.301369863013699,0.0759493670886076,0,0,0.5,0.5,0
"25009204300",2017,46,0,1,14,14,17,39,0,1,10,13,15,7,0,0,4,1,2,0,0.0217391304347826,0.304347826086957,0.304347826086957,0.369565217391304,0.847826086956522,0,0.0256410256410256,0.256410256410256,0.333333333333333,0.384615384615385,0.152173913043478,0,0,0.571428571428571,0.142857142857143,0.285714285714286
"25009204400",2017,81,0,0,15,30,36,74,0,0,15,28,31,7,0,0,0,2,5,0,0,0.185185185185185,0.37037037037037,0.444444444444444,0.91358024691358,0,0,0.202702702702703,0.378378378378378,0.418918918918919,0.0864197530864197,0,0,0,0.285714285714286,0.714285714285714
"25009204500",2017,63,0,1,17,21,24,58,0,0,14,20,24,5,0,1,3,1,0,0,0.0158730158730159,0.26984126984127,0.333333333333333,0.380952380952381,0.920634920634921,0,0,0.241379310344828,0.344827586206897,0.413793103448276,0.0793650793650794,0,0.2,0.6,0.2,0
"25009204600",2017,94,0,1,22,40,31,87,0,0,21,37,29,7,0,1,1,3,2,0,0.0106382978723404,0.234042553191489,0.425531914893617,0.329787234042553,0.925531914893617,0,0,0.241379310344828,0.425287356321839,0.333333333333333,0.074468085106383,0,0.142857142857143,0.142857142857143,0.428571428571429,0.285714285714286
"25009204701",2017,90,0,0,19,43,28,86,0,0,18,40,28,4,0,0,1,3,0,0,0,0.211111111111111,0.477777777777778,0.311111111111111,0.955555555555556,0,0,0.209302325581395,0.465116279069767,0.325581395348837,0.0444444444444444,0,0,0.25,0.75,0
"25009204702",2017,94,0,0,23,45,26,91,0,0,22,43,26,3,0,0,1,2,0,0,0,0.24468085106383,0.478723404255319,0.276595744680851,0.968085106382979,0,0,0.241758241758242,0.472527472527473,0.285714285714286,0.0319148936170213,0,0,0.333333333333333,0.666666666666667,0
"25009205100",2017,113,0,0,42,59,12,105,0,0,40,53,12,8,0,0,2,6,0,0,0,0.371681415929204,0.52212389380531,0.106194690265487,0.929203539823009,0,0,0.380952380952381,0.504761904761905,0.114285714285714,0.0707964601769911,0,0,0.25,0.75,0
"25009205200",2017,100,0,1,54,34,11,91,0,1,49,31,10,9,0,0,5,3,1,0,0.01,0.54,0.34,0.11,0.91,0,0.010989010989011,0.538461538461538,0.340659340659341,0.10989010989011,0.09,0,0,0.555555555555556,0.333333333333333,0.111111111111111
"25009205300",2017,92,0,1,35,41,15,82,0,0,30,37,15,10,0,1,5,4,0,0,0.0108695652173913,0.380434782608696,0.445652173913043,0.16304347826087,0.891304347826087,0,0,0.365853658536585,0.451219512195122,0.182926829268293,0.108695652173913,0,0.1,0.5,0.4,0
"25009205400",2017,76,0,0,25,31,20,71,0,0,23,30,18,5,0,0,2,1,2,0,0,0.328947368421053,0.407894736842105,0.263157894736842,0.934210526315789,0,0,0.323943661971831,0.422535211267606,0.253521126760563,0.0657894736842105,0,0,0.4,0.2,0.4
"25009205500",2017,79,0,2,23,47,7,69,0,0,19,44,6,10,0,2,4,3,1,0,0.0253164556962025,0.291139240506329,0.594936708860759,0.0886075949367089,0.873417721518987,0,0,0.27536231884058,0.63768115942029,0.0869565217391304,0.126582278481013,0,0.2,0.4,0.3,0.1
"25009205600",2017,55,0,1,20,29,5,50,0,0,18,27,5,5,0,1,2,2,0,0,0.0181818181818182,0.363636363636364,0.527272727272727,0.0909090909090909,0.909090909090909,0,0,0.36,0.54,0.1,0.0909090909090909,0,0.2,0.4,0.4,0
"25009205700",2017,72,0,1,27,40,4,65,0,1,26,34,4,7,0,0,1,6,0,0,0.0138888888888889,0.375,0.555555555555556,0.0555555555555556,0.902777777777778,0,0.0153846153846154,0.4,0.523076923076923,0.0615384615384615,0.0972222222222222,0,0,0.142857142857143,0.857142857142857,0
"25009205800",2017,39,0,3,20,13,3,37,0,2,19,13,3,2,0,1,1,0,0,0,0.0769230769230769,0.512820512820513,0.333333333333333,0.0769230769230769,0.948717948717949,0,0.0540540540540541,0.513513513513513,0.351351351351351,0.0810810810810811,0.0512820512820513,0,0.5,0.5,0,0
"25009205900",2017,63,0,0,28,30,5,55,0,0,25,25,5,8,0,0,3,5,0,0,0,0.444444444444444,0.476190476190476,0.0793650793650794,0.873015873015873,0,0,0.454545454545455,0.454545454545455,0.0909090909090909,0.126984126984127,0,0,0.375,0.625,0
"25009206000",2017,28,0,1,13,13,1,23,0,1,10,11,1,5,0,0,3,2,0,0,0.0357142857142857,0.464285714285714,0.464285714285714,0.0357142857142857,0.821428571428571,0,0.0434782608695652,0.434782608695652,0.478260869565217,0.0434782608695652,0.178571428571429,0,0,0.6,0.4,0
"25009206100",2017,34,0,0,14,14,6,30,0,0,12,12,6,4,0,0,2,2,0,0,0,0.411764705882353,0.411764705882353,0.176470588235294,0.882352941176471,0,0,0.4,0.4,0.2,0.117647058823529,0,0,0.5,0.5,0
"25009206200",2017,29,0,0,13,13,3,27,0,0,12,12,3,2,0,0,1,1,0,0,0,0.448275862068966,0.448275862068966,0.103448275862069,0.931034482758621,0,0,0.444444444444444,0.444444444444444,0.111111111111111,0.0689655172413793,0,0,0.5,0.5,0
"25009206300",2017,60,0,1,32,21,6,53,0,1,29,20,3,7,0,0,3,1,3,0,0.0166666666666667,0.533333333333333,0.35,0.1,0.883333333333333,0,0.0188679245283019,0.547169811320755,0.377358490566038,0.0566037735849057,0.116666666666667,0,0,0.428571428571429,0.142857142857143,0.428571428571429
"25009206400",2017,94,0,3,41,41,9,77,0,3,33,32,9,17,0,0,8,9,0,0,0.0319148936170213,0.436170212765957,0.436170212765957,0.0957446808510638,0.819148936170213,0,0.038961038961039,0.428571428571429,0.415584415584416,0.116883116883117,0.180851063829787,0,0,0.470588235294118,0.529411764705882,0
"25009206500",2017,43,1,2,14,22,4,37,1,2,12,19,3,6,0,0,2,3,1,0.0232558139534884,0.0465116279069767,0.325581395348837,0.511627906976744,0.0930232558139535,0.86046511627907,0.027027027027027,0.0540540540540541,0.324324324324324,0.513513513513513,0.0810810810810811,0.13953488372093,0,0,0.333333333333333,0.5,0.166666666666667
"25009206600",2017,60,0,1,17,31,11,51,0,1,16,24,10,9,0,0,1,7,1,0,0.0166666666666667,0.283333333333333,0.516666666666667,0.183333333333333,0.85,0,0.0196078431372549,0.313725490196078,0.470588235294118,0.196078431372549,0.15,0,0,0.111111111111111,0.777777777777778,0.111111111111111
"25009206700",2017,47,0,3,20,17,7,41,0,3,16,15,7,6,0,0,4,2,0,0,0.0638297872340425,0.425531914893617,0.361702127659574,0.148936170212766,0.872340425531915,0,0.0731707317073171,0.390243902439024,0.365853658536585,0.170731707317073,0.127659574468085,0,0,0.666666666666667,0.333333333333333,0
"25009206800",2017,29,0,1,17,8,3,26,0,0,16,8,2,3,0,1,1,0,1,0,0.0344827586206897,0.586206896551724,0.275862068965517,0.103448275862069,0.896551724137931,0,0,0.615384615384615,0.307692307692308,0.0769230769230769,0.103448275862069,0,0.333333333333333,0.333333333333333,0,0.333333333333333
"25009206900",2017,35,0,3,11,12,9,25,0,2,6,9,8,10,0,1,5,3,1,0,0.0857142857142857,0.314285714285714,0.342857142857143,0.257142857142857,0.714285714285714,0,0.08,0.24,0.36,0.32,0.285714285714286,0,0.1,0.5,0.3,0.1
"25009207000",2017,7,0,0,5,2,0,6,0,0,4,2,0,1,0,0,1,0,0,0,0,0.714285714285714,0.285714285714286,0,0.857142857142857,0,0,0.666666666666667,0.333333333333333,0,0.142857142857143,0,0,1,0,0
"25009207100",2017,25,0,0,15,7,3,20,0,0,12,5,3,5,0,0,3,2,0,0,0,0.6,0.28,0.12,0.8,0,0,0.6,0.25,0.15,0.2,0,0,0.6,0.4,0
"25009207200",2017,14,0,0,7,7,0,12,0,0,6,6,0,2,0,0,1,1,0,0,0,0.5,0.5,0,0.857142857142857,0,0,0.5,0.5,0,0.142857142857143,0,0,0.5,0.5,0
"25009208101",2017,90,0,1,23,49,17,78,0,1,16,45,16,12,0,0,7,4,1,0,0.0111111111111111,0.255555555555556,0.544444444444444,0.188888888888889,0.866666666666667,0,0.0128205128205128,0.205128205128205,0.576923076923077,0.205128205128205,0.133333333333333,0,0,0.583333333333333,0.333333333333333,0.0833333333333333
"25009208102",2017,57,0,0,16,30,11,52,0,0,14,27,11,5,0,0,2,3,0,0,0,0.280701754385965,0.526315789473684,0.192982456140351,0.912280701754386,0,0,0.269230769230769,0.519230769230769,0.211538461538462,0.087719298245614,0,0,0.4,0.6,0
"25009208200",2017,73,0,2,26,31,14,61,0,0,24,24,13,12,0,2,2,7,1,0,0.0273972602739726,0.356164383561644,0.424657534246575,0.191780821917808,0.835616438356164,0,0,0.39344262295082,0.39344262295082,0.213114754098361,0.164383561643836,0,0.166666666666667,0.166666666666667,0.583333333333333,0.0833333333333333
"25009208300",2017,100,0,1,24,49,26,88,0,0,21,42,25,12,0,1,3,7,1,0,0.01,0.24,0.49,0.26,0.88,0,0,0.238636363636364,0.477272727272727,0.284090909090909,0.12,0,0.0833333333333333,0.25,0.583333333333333,0.0833333333333333
"25009208400",2017,73,0,0,11,40,22,69,0,0,11,38,20,4,0,0,0,2,2,0,0,0.150684931506849,0.547945205479452,0.301369863013699,0.945205479452055,0,0,0.159420289855072,0.550724637681159,0.289855072463768,0.0547945205479452,0,0,0,0.5,0.5
"25009209100",2017,89,0,1,7,25,56,86,0,1,7,23,55,3,0,0,0,2,1,0,0.0112359550561798,0.0786516853932584,0.280898876404494,0.629213483146067,0.966292134831461,0,0.0116279069767442,0.0813953488372093,0.267441860465116,0.63953488372093,0.0337078651685393,0,0,0,0.666666666666667,0.333333333333333
"25009209200",2017,101,0,0,2,21,78,95,0,0,1,21,73,6,0,0,1,0,5,0,0,0.0198019801980198,0.207920792079208,0.772277227722772,0.940594059405941,0,0,0.0105263157894737,0.221052631578947,0.768421052631579,0.0594059405940594,0,0,0.166666666666667,0,0.833333333333333
"25009210100",2017,93,0,2,19,33,39,84,0,0,14,31,39,9,0,2,5,2,0,0,0.021505376344086,0.204301075268817,0.354838709677419,0.419354838709677,0.903225806451613,0,0,0.166666666666667,0.369047619047619,0.464285714285714,0.0967741935483871,0,0.222222222222222,0.555555555555556,0.222222222222222,0
"25009210200",2017,64,0,0,10,35,19,63,0,0,10,34,19,1,0,0,0,1,0,0,0,0.15625,0.546875,0.296875,0.984375,0,0,0.158730158730159,0.53968253968254,0.301587301587302,0.015625,0,0,0,1,0
"25009210300",2017,75,0,2,25,34,14,68,0,1,23,32,12,7,0,1,2,2,2,0,0.0266666666666667,0.333333333333333,0.453333333333333,0.186666666666667,0.906666666666667,0,0.0147058823529412,0.338235294117647,0.470588235294118,0.176470588235294,0.0933333333333333,0,0.142857142857143,0.285714285714286,0.285714285714286,0.285714285714286
"25009210400",2017,106,0,3,36,51,16,102,0,2,35,50,15,4,0,1,1,1,1,0,0.0283018867924528,0.339622641509434,0.481132075471698,0.150943396226415,0.962264150943396,0,0.0196078431372549,0.343137254901961,0.490196078431373,0.147058823529412,0.0377358490566038,0,0.25,0.25,0.25,0.25
"25009210500",2017,105,0,1,18,54,32,97,0,1,16,50,30,8,0,0,2,4,2,0,0.00952380952380952,0.171428571428571,0.514285714285714,0.304761904761905,0.923809523809524,0,0.0103092783505155,0.164948453608247,0.515463917525773,0.309278350515464,0.0761904761904762,0,0,0.25,0.5,0.25
"25009210600",2017,59,0,2,22,29,6,56,0,2,20,28,6,3,0,0,2,1,0,0,0.0338983050847458,0.372881355932203,0.491525423728814,0.101694915254237,0.949152542372881,0,0.0357142857142857,0.357142857142857,0.5,0.107142857142857,0.0508474576271186,0,0,0.666666666666667,0.333333333333333,0
"25009210700",2017,64,0,1,26,26,11,58,0,1,24,22,11,6,0,0,2,4,0,0,0.015625,0.40625,0.40625,0.171875,0.90625,0,0.0172413793103448,0.413793103448276,0.379310344827586,0.189655172413793,0.09375,0,0,0.333333333333333,0.666666666666667,0
"25009210800",2017,60,0,2,30,24,4,54,0,2,28,21,3,6,0,0,2,3,1,0,0.0333333333333333,0.5,0.4,0.0666666666666667,0.9,0,0.037037037037037,0.518518518518518,0.388888888888889,0.0555555555555556,0.1,0,0,0.333333333333333,0.5,0.166666666666667
"25009210900",2017,48,0,0,15,22,11,42,0,0,12,21,9,6,0,0,3,1,2,0,0,0.3125,0.458333333333333,0.229166666666667,0.875,0,0,0.285714285714286,0.5,0.214285714285714,0.125,0,0,0.5,0.166666666666667,0.333333333333333
"25009211100",2017,70,0,1,11,26,32,63,0,1,10,24,28,7,0,0,1,2,4,0,0.0142857142857143,0.157142857142857,0.371428571428571,0.457142857142857,0.9,0,0.0158730158730159,0.158730158730159,0.380952380952381,0.444444444444444,0.1,0,0,0.142857142857143,0.285714285714286,0.571428571428571
"25009211200",2017,126,0,3,28,56,39,121,0,3,28,55,35,5,0,0,0,1,4,0,0.0238095238095238,0.222222222222222,0.444444444444444,0.30952380952381,0.96031746031746,0,0.0247933884297521,0.231404958677686,0.454545454545455,0.289256198347107,0.0396825396825397,0,0,0,0.2,0.8
"25009211300",2017,67,0,0,4,26,37,66,0,0,4,25,37,1,0,0,0,1,0,0,0,0.0597014925373134,0.388059701492537,0.552238805970149,0.985074626865672,0,0,0.0606060606060606,0.378787878787879,0.560606060606061,0.0149253731343284,0,0,0,1,0
"25009211401",2017,36,0,0,13,7,16,32,0,0,11,7,14,4,0,0,2,0,2,0,0,0.361111111111111,0.194444444444444,0.444444444444444,0.888888888888889,0,0,0.34375,0.21875,0.4375,0.111111111111111,0,0,0.5,0,0.5
"25009211402",2017,101,1,0,17,43,40,93,0,0,12,42,39,8,1,0,5,1,1,0.0099009900990099,0,0.168316831683168,0.425742574257426,0.396039603960396,0.920792079207921,0,0,0.129032258064516,0.451612903225806,0.419354838709677,0.0792079207920792,0.125,0,0.625,0.125,0.125
"25009212100",2017,135,0,0,16,52,67,124,0,0,15,48,61,11,0,0,1,4,6,0,0,0.118518518518519,0.385185185185185,0.496296296296296,0.918518518518519,0,0,0.120967741935484,0.387096774193548,0.491935483870968,0.0814814814814815,0,0,0.0909090909090909,0.363636363636364,0.545454545454545
"25009213100",2017,137,0,0,10,27,100,126,0,0,9,26,91,11,0,0,1,1,9,0,0,0.072992700729927,0.197080291970803,0.72992700729927,0.91970802919708,0,0,0.0714285714285714,0.206349206349206,0.722222222222222,0.0802919708029197,0,0,0.0909090909090909,0.0909090909090909,0.818181818181818
"25009214100",2017,88,0,1,3,17,67,86,0,1,3,17,65,2,0,0,0,0,2,0,0.0113636363636364,0.0340909090909091,0.193181818181818,0.761363636363636,0.977272727272727,0,0.0116279069767442,0.0348837209302326,0.197674418604651,0.755813953488372,0.0227272727272727,0,0,0,0,1
"25009215101",2017,69,0,0,5,18,46,63,0,0,3,16,44,6,0,0,2,2,2,0,0,0.072463768115942,0.260869565217391,0.666666666666667,0.91304347826087,0,0,0.0476190476190476,0.253968253968254,0.698412698412698,0.0869565217391304,0,0,0.333333333333333,0.333333333333333,0.333333333333333
"25009215102",2017,38,0,0,4,15,19,38,0,0,4,15,19,0,0,0,0,0,0,0,0,0.105263157894737,0.394736842105263,0.5,1,0,0,0.105263157894737,0.394736842105263,0.5,0,0,0,0,0,0
"25009216100",2017,56,0,0,4,17,35,52,0,0,4,14,34,4,0,0,0,3,1,0,0,0.0714285714285714,0.303571428571429,0.625,0.928571428571429,0,0,0.0769230769230769,0.269230769230769,0.653846153846154,0.0714285714285714,0,0,0,0.75,0.25
"25009217100",2017,69,0,1,8,31,29,65,0,0,7,30,28,4,0,1,1,1,1,0,0.0144927536231884,0.115942028985507,0.449275362318841,0.420289855072464,0.942028985507246,0,0,0.107692307692308,0.461538461538462,0.430769230769231,0.0579710144927536,0,0.25,0.25,0.25,0.25
"25009217201",2017,50,0,1,9,26,14,46,0,0,9,24,13,4,0,1,0,2,1,0,0.02,0.18,0.52,0.28,0.92,0,0,0.195652173913043,0.521739130434783,0.282608695652174,0.08,0,0.25,0,0.5,0.25
"25009217202",2017,51,0,0,5,25,21,48,0,0,3,25,20,3,0,0,2,0,1,0,0,0.0980392156862745,0.490196078431373,0.411764705882353,0.941176470588235,0,0,0.0625,0.520833333333333,0.416666666666667,0.0588235294117647,0,0,0.666666666666667,0,0.333333333333333
"25009217300",2017,82,0,1,20,35,26,78,0,1,19,32,26,4,0,0,1,3,0,0,0.0121951219512195,0.24390243902439,0.426829268292683,0.317073170731707,0.951219512195122,0,0.0128205128205128,0.243589743589744,0.41025641025641,0.333333333333333,0.0487804878048781,0,0,0.25,0.75,0
"25009217400",2017,104,0,1,22,43,38,97,0,1,18,42,36,7,0,0,4,1,2,0,0.00961538461538462,0.211538461538462,0.413461538461538,0.365384615384615,0.932692307692308,0,0.0103092783505155,0.185567010309278,0.43298969072165,0.371134020618557,0.0673076923076923,0,0,0.571428571428571,0.142857142857143,0.285714285714286
"25009217500",2017,87,1,2,8,33,43,82,1,1,8,31,41,5,0,1,0,2,2,0.0114942528735632,0.0229885057471264,0.0919540229885057,0.379310344827586,0.494252873563218,0.942528735632184,0.0121951219512195,0.0121951219512195,0.0975609756097561,0.378048780487805,0.5,0.0574712643678161,0,0.2,0,0.4,0.4
"25009217600",2017,107,0,0,5,17,85,101,0,0,4,17,80,6,0,0,1,0,5,0,0,0.0467289719626168,0.158878504672897,0.794392523364486,0.94392523364486,0,0,0.0396039603960396,0.168316831683168,0.792079207920792,0.0560747663551402,0,0,0.166666666666667,0,0.833333333333333
"25009218100",2017,70,0,0,3,13,54,67,0,0,3,12,52,3,0,0,0,1,2,0,0,0.0428571428571429,0.185714285714286,0.771428571428571,0.957142857142857,0,0,0.0447761194029851,0.17910447761194,0.776119402985075,0.0428571428571429,0,0,0,0.333333333333333,0.666666666666667
"25009220101",2017,57,1,2,6,20,28,52,1,1,6,18,26,5,0,1,0,2,2,0.0175438596491228,0.0350877192982456,0.105263157894737,0.350877192982456,0.491228070175439,0.912280701754386,0.0192307692307692,0.0192307692307692,0.115384615384615,0.346153846153846,0.5,0.087719298245614,0,0.2,0,0.4,0.4
"25009220102",2017,43,0,1,8,11,23,39,0,1,6,11,21,4,0,0,2,0,2,0,0.0232558139534884,0.186046511627907,0.255813953488372,0.534883720930233,0.906976744186046,0,0.0256410256410256,0.153846153846154,0.282051282051282,0.538461538461538,0.0930232558139535,0,0,0.5,0,0.5
"25009221100",2017,50,0,0,7,17,26,44,0,0,7,16,21,6,0,0,0,1,5,0,0,0.14,0.34,0.52,0.88,0,0,0.159090909090909,0.363636363636364,0.477272727272727,0.12,0,0,0,0.166666666666667,0.833333333333333
"25009221300",2017,56,0,1,8,16,31,49,0,1,7,15,26,7,0,0,1,1,5,0,0.0178571428571429,0.142857142857143,0.285714285714286,0.553571428571429,0.875,0,0.0204081632653061,0.142857142857143,0.306122448979592,0.530612244897959,0.125,0,0,0.142857142857143,0.142857142857143,0.714285714285714
"25009221400",2017,32,1,2,13,11,5,31,1,1,13,11,5,1,0,1,0,0,0,0.03125,0.0625,0.40625,0.34375,0.15625,0.96875,0.032258064516129,0.032258064516129,0.419354838709677,0.354838709677419,0.161290322580645,0.03125,0,1,0,0,0
"25009221500",2017,25,0,0,6,10,9,23,0,0,6,8,9,2,0,0,0,2,0,0,0,0.24,0.4,0.36,0.92,0,0,0.260869565217391,0.347826086956522,0.391304347826087,0.08,0,0,0,1,0
"25009221600",2017,35,0,2,11,16,6,28,0,1,8,16,3,7,0,1,3,0,3,0,0.0571428571428571,0.314285714285714,0.457142857142857,0.171428571428571,0.8,0,0.0357142857142857,0.285714285714286,0.571428571428571,0.107142857142857,0.2,0,0.142857142857143,0.428571428571429,0,0.428571428571429
"25009221700",2017,22,0,1,7,7,7,19,0,1,7,7,4,3,0,0,0,0,3,0,0.0454545454545455,0.318181818181818,0.318181818181818,0.318181818181818,0.863636363636364,0,0.0526315789473684,0.368421052631579,0.368421052631579,0.210526315789474,0.136363636363636,0,0,0,0,1
"25009221800",2017,13,0,0,1,9,3,13,0,0,1,9,3,0,0,0,0,0,0,0,0,0.0769230769230769,0.692307692307692,0.230769230769231,1,0,0,0.0769230769230769,0.692307692307692,0.230769230769231,0,0,0,0,0,0
"25009221901",2017,56,0,1,13,19,23,52,0,1,12,16,23,4,0,0,1,3,0,0,0.0178571428571429,0.232142857142857,0.339285714285714,0.410714285714286,0.928571428571429,0,0.0192307692307692,0.230769230769231,0.307692307692308,0.442307692307692,0.0714285714285714,0,0,0.25,0.75,0
"25009221902",2017,58,0,1,13,20,24,53,0,1,10,20,22,5,0,0,3,0,2,0,0.0172413793103448,0.224137931034483,0.344827586206897,0.413793103448276,0.913793103448276,0,0.0188679245283019,0.188679245283019,0.377358490566038,0.415094339622642,0.0862068965517241,0,0,0.6,0,0.4
"25009222100",2017,66,0,0,4,21,41,57,0,0,4,19,34,9,0,0,0,2,7,0,0,0.0606060606060606,0.318181818181818,0.621212121212121,0.863636363636364,0,0,0.0701754385964912,0.333333333333333,0.596491228070175,0.136363636363636,0,0,0,0.222222222222222,0.777777777777778
"25009223100",2017,54,0,0,8,14,32,51,0,0,7,13,31,3,0,0,1,1,1,0,0,0.148148148148148,0.259259259259259,0.592592592592593,0.944444444444444,0,0,0.137254901960784,0.254901960784314,0.607843137254902,0.0555555555555556,0,0,0.333333333333333,0.333333333333333,0.333333333333333
"25009223200",2017,52,0,1,13,21,17,49,0,1,10,21,17,3,0,0,3,0,0,0,0.0192307692307692,0.25,0.403846153846154,0.326923076923077,0.942307692307692,0,0.0204081632653061,0.204081632653061,0.428571428571429,0.346938775510204,0.0576923076923077,0,0,1,0,0
"25009223300",2017,99,0,1,13,31,54,93,0,1,13,29,50,6,0,0,0,2,4,0,0.0101010101010101,0.131313131313131,0.313131313131313,0.545454545454545,0.939393939393939,0,0.010752688172043,0.139784946236559,0.311827956989247,0.537634408602151,0.0606060606060606,0,0,0,0.333333333333333,0.666666666666667
"25009250100",2017,1,0,0,0,1,0,0,0,0,0,0,0,1,0,0,0,1,0,0,0,0,1,0,0,0,0,0,0,0,1,0,0,0,1,0
"25009250200",2017,69,0,1,51,14,3,64,0,1,48,12,3,5,0,0,3,2,0,0,0.0144927536231884,0.739130434782609,0.202898550724638,0.0434782608695652,0.927536231884058,0,0.015625,0.75,0.1875,0.046875,0.072463768115942,0,0,0.6,0.4,0
"25009250300",2017,21,0,1,11,9,0,15,0,1,7,7,0,6,0,0,4,2,0,0,0.0476190476190476,0.523809523809524,0.428571428571429,0,0.714285714285714,0,0.0666666666666667,0.466666666666667,0.466666666666667,0,0.285714285714286,0,0,0.666666666666667,0.333333333333333,0
"25009250400",2017,24,1,1,15,6,1,23,0,1,15,6,1,1,1,0,0,0,0,0.0416666666666667,0.0416666666666667,0.625,0.25,0.0416666666666667,0.958333333333333,0,0.0434782608695652,0.652173913043478,0.260869565217391,0.0434782608695652,0.0416666666666667,1,0,0,0,0
"25009250500",2017,33,0,4,22,7,0,26,0,4,17,5,0,7,0,0,5,2,0,0,0.121212121212121,0.666666666666667,0.212121212121212,0,0.787878787878788,0,0.153846153846154,0.653846153846154,0.192307692307692,0,0.212121212121212,0,0,0.714285714285714,0.285714285714286,0
"25009250600",2017,60,1,8,34,15,2,53,0,8,32,11,2,7,1,0,2,4,0,0.0166666666666667,0.133333333333333,0.566666666666667,0.25,0.0333333333333333,0.883333333333333,0,0.150943396226415,0.60377358490566,0.207547169811321,0.0377358490566038,0.116666666666667,0.142857142857143,0,0.285714285714286,0.571428571428571,0
"25009250700",2017,39,0,11,17,10,1,28,0,6,14,8,0,11,0,5,3,2,1,0,0.282051282051282,0.435897435897436,0.256410256410256,0.0256410256410256,0.717948717948718,0,0.214285714285714,0.5,0.285714285714286,0,0.282051282051282,0,0.454545454545455,0.272727272727273,0.181818181818182,0.0909090909090909
"25009250800",2017,103,2,9,57,30,5,81,0,9,41,26,5,22,2,0,16,4,0,0.0194174757281553,0.087378640776699,0.553398058252427,0.29126213592233,0.0485436893203883,0.786407766990291,0,0.111111111111111,0.506172839506173,0.320987654320988,0.0617283950617284,0.213592233009709,0.0909090909090909,0,0.727272727272727,0.181818181818182,0
"25009250900",2017,9,0,0,6,3,0,8,0,0,5,3,0,1,0,0,1,0,0,0,0,0.666666666666667,0.333333333333333,0,0.888888888888889,0,0,0.625,0.375,0,0.111111111111111,0,0,1,0,0
"25009251000",2017,6,0,0,4,1,1,3,0,0,2,0,1,3,0,0,2,1,0,0,0,0.666666666666667,0.166666666666667,0.166666666666667,0.5,0,0,0.666666666666667,0,0.333333333333333,0.5,0,0,0.666666666666667,0.333333333333333,0
"25009251100",2017,7,0,1,2,4,0,6,0,1,1,4,0,1,0,0,1,0,0,0,0.142857142857143,0.285714285714286,0.571428571428571,0,0.857142857142857,0,0.166666666666667,0.166666666666667,0.666666666666667,0,0.142857142857143,0,0,1,0,0
"25009251200",2017,7,0,1,5,1,0,5,0,0,4,1,0,2,0,1,1,0,0,0,0.142857142857143,0.714285714285714,0.142857142857143,0,0.714285714285714,0,0,0.8,0.2,0,0.285714285714286,0,0.5,0.5,0,0
"25009251300",2017,30,0,3,21,6,0,23,0,1,18,4,0,7,0,2,3,2,0,0,0.1,0.7,0.2,0,0.766666666666667,0,0.0434782608695652,0.782608695652174,0.173913043478261,0,0.233333333333333,0,0.285714285714286,0.428571428571429,0.285714285714286,0
"25009251400",2017,37,0,3,26,8,0,34,0,2,24,8,0,3,0,1,2,0,0,0,0.0810810810810811,0.702702702702703,0.216216216216216,0,0.918918918918919,0,0.0588235294117647,0.705882352941177,0.235294117647059,0,0.0810810810810811,0,0.333333333333333,0.666666666666667,0,0
"25009251500",2017,58,0,7,35,14,2,45,0,3,27,13,2,13,0,4,8,1,0,0,0.120689655172414,0.603448275862069,0.241379310344828,0.0344827586206897,0.775862068965517,0,0.0666666666666667,0.6,0.288888888888889,0.0444444444444444,0.224137931034483,0,0.307692307692308,0.615384615384615,0.0769230769230769,0
"25009251600",2017,41,0,5,26,8,2,37,0,4,23,8,2,4,0,1,3,0,0,0,0.121951219512195,0.634146341463415,0.195121951219512,0.0487804878048781,0.902439024390244,0,0.108108108108108,0.621621621621622,0.216216216216216,0.0540540540540541,0.0975609756097561,0,0.25,0.75,0,0
"25009251700",2017,54,0,3,34,16,1,43,0,3,25,14,1,11,0,0,9,2,0,0,0.0555555555555556,0.62962962962963,0.296296296296296,0.0185185185185185,0.796296296296296,0,0.0697674418604651,0.581395348837209,0.325581395348837,0.0232558139534884,0.203703703703704,0,0,0.818181818181818,0.181818181818182,0
"25009251800",2017,125,0,6,82,31,6,107,0,5,70,26,6,18,0,1,12,5,0,0,0.048,0.656,0.248,0.048,0.856,0,0.0467289719626168,0.654205607476635,0.242990654205607,0.0560747663551402,0.144,0,0.0555555555555556,0.666666666666667,0.277777777777778,0
"25009252101",2017,60,0,1,31,24,4,57,0,1,30,22,4,3,0,0,1,2,0,0,0.0166666666666667,0.516666666666667,0.4,0.0666666666666667,0.95,0,0.0175438596491228,0.526315789473684,0.385964912280702,0.0701754385964912,0.05,0,0,0.333333333333333,0.666666666666667,0
"25009252102",2017,67,0,2,12,23,30,65,0,2,10,23,30,2,0,0,2,0,0,0,0.0298507462686567,0.17910447761194,0.343283582089552,0.447761194029851,0.970149253731343,0,0.0307692307692308,0.153846153846154,0.353846153846154,0.461538461538462,0.0298507462686567,0,0,1,0,0
"25009252201",2017,52,0,1,14,23,14,51,0,1,13,23,14,1,0,0,1,0,0,0,0.0192307692307692,0.269230769230769,0.442307692307692,0.269230769230769,0.980769230769231,0,0.0196078431372549,0.254901960784314,0.450980392156863,0.274509803921569,0.0192307692307692,0,0,1,0,0
"25009252202",2017,45,0,1,12,18,14,44,0,1,12,17,14,1,0,0,0,1,0,0,0.0222222222222222,0.266666666666667,0.4,0.311111111111111,0.977777777777778,0,0.0227272727272727,0.272727272727273,0.386363636363636,0.318181818181818,0.0222222222222222,0,0,0,1,0
"25009252300",2017,92,1,2,52,27,10,84,1,1,47,27,8,8,0,1,5,0,2,0.0108695652173913,0.0217391304347826,0.565217391304348,0.293478260869565,0.108695652173913,0.91304347826087,0.0119047619047619,0.0119047619047619,0.55952380952381,0.321428571428571,0.0952380952380952,0.0869565217391304,0,0.125,0.625,0,0.25
"25009252400",2017,44,0,1,27,13,3,40,0,1,24,12,3,4,0,0,3,1,0,0,0.0227272727272727,0.613636363636364,0.295454545454545,0.0681818181818182,0.909090909090909,0,0.025,0.6,0.3,0.075,0.0909090909090909,0,0,0.75,0.25,0
"25009252501",2017,67,0,0,36,24,7,62,0,0,32,23,7,5,0,0,4,1,0,0,0,0.537313432835821,0.358208955223881,0.104477611940299,0.925373134328358,0,0,0.516129032258065,0.370967741935484,0.112903225806452,0.0746268656716418,0,0,0.8,0.2,0
"25009252502",2017,86,0,3,36,36,11,76,0,2,31,33,10,10,0,1,5,3,1,0,0.0348837209302326,0.418604651162791,0.418604651162791,0.127906976744186,0.883720930232558,0,0.0263157894736842,0.407894736842105,0.434210526315789,0.131578947368421,0.116279069767442,0,0.1,0.5,0.3,0.1
"25009252601",2017,117,0,4,50,49,14,105,0,1,43,47,14,12,0,3,7,2,0,0,0.0341880341880342,0.427350427350427,0.418803418803419,0.11965811965812,0.897435897435897,0,0.00952380952380952,0.40952380952381,0.447619047619048,0.133333333333333,0.102564102564103,0,0.25,0.583333333333333,0.166666666666667,0
"25009252602",2017,98,0,0,23,39,36,88,0,0,20,37,31,10,0,0,3,2,5,0,0,0.23469387755102,0.397959183673469,0.36734693877551,0.897959183673469,0,0,0.227272727272727,0.420454545454545,0.352272727272727,0.102040816326531,0,0,0.3,0.2,0.5
"25009252603",2017,37,0,1,8,21,7,34,0,1,7,20,6,3,0,0,1,1,1,0,0.027027027027027,0.216216216216216,0.567567567567568,0.189189189189189,0.918918918918919,0,0.0294117647058824,0.205882352941176,0.588235294117647,0.176470588235294,0.0810810810810811,0,0,0.333333333333333,0.333333333333333,0.333333333333333
"25009253100",2017,84,0,2,20,38,24,82,0,1,20,37,24,2,0,1,0,1,0,0,0.0238095238095238,0.238095238095238,0.452380952380952,0.285714285714286,0.976190476190476,0,0.0121951219512195,0.24390243902439,0.451219512195122,0.292682926829268,0.0238095238095238,0,0.5,0,0.5,0
"25009253201",2017,56,0,0,14,14,28,50,0,0,12,13,25,6,0,0,2,1,3,0,0,0.25,0.25,0.5,0.892857142857143,0,0,0.24,0.26,0.5,0.107142857142857,0,0,0.333333333333333,0.166666666666667,0.5
"25009253202",2017,100,0,0,34,35,31,83,0,0,30,25,28,17,0,0,4,10,3,0,0,0.34,0.35,0.31,0.83,0,0,0.36144578313253,0.301204819277108,0.337349397590361,0.17,0,0,0.235294117647059,0.588235294117647,0.176470588235294
"25009253203",2017,52,0,0,3,8,41,48,0,0,2,6,40,4,0,0,1,2,1,0,0,0.0576923076923077,0.153846153846154,0.788461538461538,0.923076923076923,0,0,0.0416666666666667,0.125,0.833333333333333,0.0769230769230769,0,0,0.25,0.5,0.25
"25009253204",2017,124,0,1,19,35,69,113,0,0,14,34,65,11,0,1,5,1,4,0,0.00806451612903226,0.153225806451613,0.282258064516129,0.556451612903226,0.911290322580645,0,0,0.123893805309735,0.300884955752212,0.575221238938053,0.0887096774193548,0,0.0909090909090909,0.454545454545455,0.0909090909090909,0.363636363636364
"25009253205",2017,53,0,0,0,10,43,52,0,0,0,10,42,1,0,0,0,0,1,0,0,0,0.188679245283019,0.811320754716981,0.981132075471698,0,0,0,0.192307692307692,0.807692307692308,0.0188679245283019,0,0,0,0,1
"25009254100",2017,146,0,1,18,44,83,137,0,0,16,41,80,9,0,1,2,3,3,0,0.00684931506849315,0.123287671232877,0.301369863013699,0.568493150684932,0.938356164383562,0,0,0.116788321167883,0.299270072992701,0.583941605839416,0.0616438356164384,0,0.111111111111111,0.222222222222222,0.333333333333333,0.333333333333333
"25009254200",2017,48,0,0,11,9,28,48,0,0,11,9,28,0,0,0,0,0,0,0,0,0.229166666666667,0.1875,0.583333333333333,1,0,0,0.229166666666667,0.1875,0.583333333333333,0,0,0,0,0,0
"25009254301",2017,52,0,0,6,8,38,49,0,0,5,6,38,3,0,0,1,2,0,0,0,0.115384615384615,0.153846153846154,0.730769230769231,0.942307692307692,0,0,0.102040816326531,0.122448979591837,0.775510204081633,0.0576923076923077,0,0,0.333333333333333,0.666666666666667,0
"25009254302",2017,62,0,0,8,15,39,56,0,0,8,15,33,6,0,0,0,0,6,0,0,0.129032258064516,0.241935483870968,0.629032258064516,0.903225806451613,0,0,0.142857142857143,0.267857142857143,0.589285714285714,0.0967741935483871,0,0,0,0,1
"25009254401",2017,42,0,0,0,18,24,41,0,0,0,18,23,1,0,0,0,0,1,0,0,0,0.428571428571429,0.571428571428571,0.976190476190476,0,0,0,0.439024390243902,0.560975609756098,0.0238095238095238,0,0,0,0,1
"25009254402",2017,120,0,0,5,25,90,109,0,0,4,20,85,11,0,0,1,5,5,0,0,0.0416666666666667,0.208333333333333,0.75,0.908333333333333,0,0,0.036697247706422,0.18348623853211,0.779816513761468,0.0916666666666667,0,0,0.0909090909090909,0.454545454545455,0.454545454545455
"25009254403",2017,56,0,0,3,12,41,54,0,0,3,11,40,2,0,0,0,1,1,0,0,0.0535714285714286,0.214285714285714,0.732142857142857,0.964285714285714,0,0,0.0555555555555556,0.203703703703704,0.740740740740741,0.0357142857142857,0,0,0,0.5,0.5
"25009260100",2017,46,0,1,30,11,4,39,0,1,24,11,3,7,0,0,6,0,1,0,0.0217391304347826,0.652173913043478,0.239130434782609,0.0869565217391304,0.847826086956522,0,0.0256410256410256,0.615384615384615,0.282051282051282,0.0769230769230769,0.152173913043478,0,0,0.857142857142857,0,0.142857142857143
"25009260200",2017,34,0,2,24,7,1,30,0,2,20,7,1,4,0,0,4,0,0,0,0.0588235294117647,0.705882352941177,0.205882352941176,0.0294117647058824,0.882352941176471,0,0.0666666666666667,0.666666666666667,0.233333333333333,0.0333333333333333,0.117647058823529,0,0,1,0,0
"25009260301",2017,91,0,4,31,46,10,80,0,3,27,41,9,11,0,1,4,5,1,0,0.043956043956044,0.340659340659341,0.505494505494505,0.10989010989011,0.879120879120879,0,0.0375,0.3375,0.5125,0.1125,0.120879120879121,0,0.0909090909090909,0.363636363636364,0.454545454545455,0.0909090909090909
"25009260302",2017,37,0,0,12,17,8,35,0,0,12,16,7,2,0,0,0,1,1,0,0,0.324324324324324,0.459459459459459,0.216216216216216,0.945945945945946,0,0,0.342857142857143,0.457142857142857,0.2,0.0540540540540541,0,0,0,0.5,0.5
"25009260401",2017,71,0,2,27,36,6,61,0,1,23,31,6,10,0,1,4,5,0,0,0.028169014084507,0.380281690140845,0.507042253521127,0.0845070422535211,0.859154929577465,0,0.0163934426229508,0.377049180327869,0.508196721311475,0.0983606557377049,0.140845070422535,0,0.1,0.4,0.5,0
"25009260402",2017,120,0,2,53,38,27,110,0,2,47,35,26,10,0,0,6,3,1,0,0.0166666666666667,0.441666666666667,0.316666666666667,0.225,0.916666666666667,0,0.0181818181818182,0.427272727272727,0.318181818181818,0.236363636363636,0.0833333333333333,0,0,0.6,0.3,0.1
"25009260500",2017,71,0,3,23,32,13,67,0,2,22,32,11,4,0,1,1,0,2,0,0.0422535211267606,0.323943661971831,0.450704225352113,0.183098591549296,0.943661971830986,0,0.0298507462686567,0.328358208955224,0.477611940298507,0.164179104477612,0.0563380281690141,0,0.25,0.25,0,0.5
"25009260600",2017,60,0,1,31,22,6,55,0,1,30,18,6,5,0,0,1,4,0,0,0.0166666666666667,0.516666666666667,0.366666666666667,0.1,0.916666666666667,0,0.0181818181818182,0.545454545454545,0.327272727272727,0.109090909090909,0.0833333333333333,0,0,0.2,0.8,0
"25009260700",2017,88,0,2,44,31,11,81,0,2,41,28,10,7,0,0,3,3,1,0,0.0227272727272727,0.5,0.352272727272727,0.125,0.920454545454545,0,0.0246913580246914,0.506172839506173,0.345679012345679,0.123456790123457,0.0795454545454545,0,0,0.428571428571429,0.428571428571429,0.142857142857143
"25009260800",2017,67,1,3,45,12,6,56,0,1,40,10,5,11,1,2,5,2,1,0.0149253731343284,0.0447761194029851,0.671641791044776,0.17910447761194,0.0895522388059701,0.835820895522388,0,0.0178571428571429,0.714285714285714,0.178571428571429,0.0892857142857143,0.164179104477612,0.0909090909090909,0.181818181818182,0.454545454545455,0.181818181818182,0.0909090909090909
"25009260900",2017,113,0,5,69,34,5,104,0,3,64,32,5,9,0,2,5,2,0,0,0.0442477876106195,0.610619469026549,0.300884955752212,0.0442477876106195,0.920353982300885,0,0.0288461538461538,0.615384615384615,0.307692307692308,0.0480769230769231,0.079646017699115,0,0.222222222222222,0.555555555555556,0.222222222222222,0
"25009261000",2017,68,0,0,27,33,8,66,0,0,26,32,8,2,0,0,1,1,0,0,0,0.397058823529412,0.485294117647059,0.117647058823529,0.970588235294118,0,0,0.393939393939394,0.484848484848485,0.121212121212121,0.0294117647058824,0,0,0.5,0.5,0
"25009261101",2017,104,0,1,27,45,31,96,0,0,24,41,31,8,0,1,3,4,0,0,0.00961538461538462,0.259615384615385,0.432692307692308,0.298076923076923,0.923076923076923,0,0,0.25,0.427083333333333,0.322916666666667,0.0769230769230769,0,0.125,0.375,0.5,0
"25009261102",2017,98,0,2,49,37,10,87,0,1,44,32,10,11,0,1,5,5,0,0,0.0204081632653061,0.5,0.377551020408163,0.102040816326531,0.887755102040816,0,0.0114942528735632,0.505747126436782,0.367816091954023,0.114942528735632,0.112244897959184,0,0.0909090909090909,0.454545454545455,0.454545454545455,0
"25009262100",2017,115,0,6,34,43,32,103,0,5,29,37,32,12,0,1,5,6,0,0,0.0521739130434783,0.295652173913043,0.373913043478261,0.278260869565217,0.895652173913044,0,0.0485436893203883,0.281553398058252,0.359223300970874,0.310679611650485,0.104347826086957,0,0.0833333333333333,0.416666666666667,0.5,0
"25009263100",2017,84,0,0,3,22,59,83,0,0,3,21,59,1,0,0,0,1,0,0,0,0.0357142857142857,0.261904761904762,0.702380952380952,0.988095238095238,0,0,0.036144578313253,0.253012048192771,0.710843373493976,0.0119047619047619,0,0,0,1,0
"25009264100",2017,87,0,0,25,32,30,82,0,0,23,32,27,5,0,0,2,0,3,0,0,0.28735632183908,0.367816091954023,0.344827586206897,0.942528735632184,0,0,0.280487804878049,0.390243902439024,0.329268292682927,0.0574712643678161,0,0,0.4,0,0.6
"25009265101",2017,66,0,0,14,28,24,60,0,0,11,25,24,6,0,0,3,3,0,0,0,0.212121212121212,0.424242424242424,0.363636363636364,0.909090909090909,0,0,0.183333333333333,0.416666666666667,0.4,0.0909090909090909,0,0,0.5,0.5,0
"25009265102",2017,49,0,0,7,15,27,47,0,0,7,13,27,2,0,0,0,2,0,0,0,0.142857142857143,0.306122448979592,0.551020408163265,0.959183673469388,0,0,0.148936170212766,0.276595744680851,0.574468085106383,0.0408163265306122,0,0,0,1,0
"25009266100",2017,77,0,1,17,22,37,73,0,1,16,21,35,4,0,0,1,1,2,0,0.012987012987013,0.220779220779221,0.285714285714286,0.480519480519481,0.948051948051948,0,0.0136986301369863,0.219178082191781,0.287671232876712,0.479452054794521,0.051948051948052,0,0,0.25,0.25,0.5
"25009266200",2017,93,0,5,34,28,26,79,0,4,26,25,24,14,0,1,8,3,2,0,0.0537634408602151,0.365591397849462,0.301075268817204,0.279569892473118,0.849462365591398,0,0.0506329113924051,0.329113924050633,0.316455696202532,0.30379746835443,0.150537634408602,0,0.0714285714285714,0.571428571428571,0.214285714285714,0.142857142857143
"25009266300",2017,84,0,2,26,25,31,78,0,2,24,24,28,6,0,0,2,1,3,0,0.0238095238095238,0.30952380952381,0.297619047619048,0.369047619047619,0.928571428571429,0,0.0256410256410256,0.307692307692308,0.307692307692308,0.358974358974359,0.0714285714285714,0,0,0.333333333333333,0.166666666666667,0.5
"25009266400",2017,77,0,1,27,32,17,71,0,1,26,28,16,6,0,0,1,4,1,0,0.012987012987013,0.350649350649351,0.415584415584416,0.220779220779221,0.922077922077922,0,0.0140845070422535,0.366197183098592,0.394366197183099,0.225352112676056,0.0779220779220779,0,0,0.166666666666667,0.666666666666667,0.166666666666667
"25009267101",2017,74,0,3,19,27,25,64,0,2,17,24,21,10,0,1,2,3,4,0,0.0405405405405405,0.256756756756757,0.364864864864865,0.337837837837838,0.864864864864865,0,0.03125,0.265625,0.375,0.328125,0.135135135135135,0,0.1,0.2,0.3,0.4
"25009267102",2017,85,0,3,28,33,21,78,0,1,25,32,20,7,0,2,3,1,1,0,0.0352941176470588,0.329411764705882,0.388235294117647,0.247058823529412,0.917647058823529,0,0.0128205128205128,0.320512820512821,0.41025641025641,0.256410256410256,0.0823529411764706,0,0.285714285714286,0.428571428571429,0.142857142857143,0.142857142857143
"25009268100",2017,27,0,0,1,7,19,25,0,0,1,6,18,2,0,0,0,1,1,0,0,0.037037037037037,0.259259259259259,0.703703703703704,0.925925925925926,0,0,0.04,0.24,0.72,0.0740740740740741,0,0,0,0.5,0.5
"25009268200",2017,146,0,4,19,35,88,134,0,2,16,34,82,12,0,2,3,1,6,0,0.0273972602739726,0.13013698630137,0.23972602739726,0.602739726027397,0.917808219178082,0,0.0149253731343284,0.119402985074627,0.253731343283582,0.611940298507463,0.0821917808219178,0,0.166666666666667,0.25,0.0833333333333333,0.5
"25009268300",2017,76,0,1,9,15,51,72,0,1,9,12,50,4,0,0,0,3,1,0,0.0131578947368421,0.118421052631579,0.197368421052632,0.671052631578947,0.947368421052632,0,0.0138888888888889,0.125,0.166666666666667,0.694444444444444,0.0526315789473684,0,0,0,0.75,0.25
"25009268400",2017,99,0,0,4,27,68,93,0,0,3,26,64,6,0,0,1,1,4,0,0,0.0404040404040404,0.272727272727273,0.686868686868687,0.939393939393939,0,0,0.032258064516129,0.279569892473118,0.688172043010753,0.0606060606060606,0,0,0.166666666666667,0.166666666666667,0.666666666666667
"25009269100",2017,105,0,0,10,29,66,96,0,0,8,28,60,9,0,0,2,1,6,0,0,0.0952380952380952,0.276190476190476,0.628571428571429,0.914285714285714,0,0,0.0833333333333333,0.291666666666667,0.625,0.0857142857142857,0,0,0.222222222222222,0.111111111111111,0.666666666666667
"25009270100",2017,74,0,3,15,24,32,72,0,3,13,24,32,2,0,0,2,0,0,0,0.0405405405405405,0.202702702702703,0.324324324324324,0.432432432432432,0.972972972972973,0,0.0416666666666667,0.180555555555556,0.333333333333333,0.444444444444444,0.027027027027027,0,0,1,0,0
"25011040100",2017,52,0,6,12,24,10,44,0,4,9,21,10,8,0,2,3,3,0,0,0.115384615384615,0.230769230769231,0.461538461538462,0.192307692307692,0.846153846153846,0,0.0909090909090909,0.204545454545455,0.477272727272727,0.227272727272727,0.153846153846154,0,0.25,0.375,0.375,0
"25011040200",2017,41,0,1,17,13,10,35,0,0,13,13,9,6,0,1,4,0,1,0,0.024390243902439,0.414634146341463,0.317073170731707,0.24390243902439,0.853658536585366,0,0,0.371428571428571,0.371428571428571,0.257142857142857,0.146341463414634,0,0.166666666666667,0.666666666666667,0,0.166666666666667
"25011040300",2017,40,0,1,24,11,4,36,0,1,21,10,4,4,0,0,3,1,0,0,0.025,0.6,0.275,0.1,0.9,0,0.0277777777777778,0.583333333333333,0.277777777777778,0.111111111111111,0.1,0,0,0.75,0.25,0
"25011040400",2017,29,0,3,13,9,4,26,0,2,12,9,3,3,0,1,1,0,1,0,0.103448275862069,0.448275862068966,0.310344827586207,0.137931034482759,0.896551724137931,0,0.0769230769230769,0.461538461538462,0.346153846153846,0.115384615384615,0.103448275862069,0,0.333333333333333,0.333333333333333,0,0.333333333333333
"25011040501",2017,54,1,6,34,9,4,46,0,4,30,8,4,8,1,2,4,1,0,0.0185185185185185,0.111111111111111,0.62962962962963,0.166666666666667,0.0740740740740741,0.851851851851852,0,0.0869565217391304,0.652173913043478,0.173913043478261,0.0869565217391304,0.148148148148148,0.125,0.25,0.5,0.125,0
"25011040502",2017,48,0,10,24,11,3,40,0,9,18,10,3,8,0,1,6,1,0,0,0.208333333333333,0.5,0.229166666666667,0.0625,0.833333333333333,0,0.225,0.45,0.25,0.075,0.166666666666667,0,0.125,0.75,0.125,0
"25011040600",2017,55,0,1,20,16,18,50,0,0,18,14,18,5,0,1,2,2,0,0,0.0181818181818182,0.363636363636364,0.290909090909091,0.327272727272727,0.909090909090909,0,0,0.36,0.28,0.36,0.0909090909090909,0,0.2,0.4,0.4,0
"25011040701",2017,39,0,7,20,10,2,34,0,6,18,8,2,5,0,1,2,2,0,0,0.179487179487179,0.512820512820513,0.256410256410256,0.0512820512820513,0.871794871794872,0,0.176470588235294,0.529411764705882,0.235294117647059,0.0588235294117647,0.128205128205128,0,0.2,0.4,0.4,0
"25011040702",2017,52,0,3,25,16,8,44,0,1,20,16,7,8,0,2,5,0,1,0,0.0576923076923077,0.480769230769231,0.307692307692308,0.153846153846154,0.846153846153846,0,0.0227272727272727,0.454545454545455,0.363636363636364,0.159090909090909,0.153846153846154,0,0.25,0.625,0,0.125
"25011040800",2017,62,0,1,21,19,21,55,0,0,18,17,20,7,0,1,3,2,1,0,0.0161290322580645,0.338709677419355,0.306451612903226,0.338709677419355,0.887096774193548,0,0,0.327272727272727,0.309090909090909,0.363636363636364,0.112903225806452,0,0.142857142857143,0.428571428571429,0.285714285714286,0.142857142857143
"25011040900",2017,61,0,1,22,20,18,58,0,1,21,19,17,3,0,0,1,1,1,0,0.0163934426229508,0.360655737704918,0.327868852459016,0.295081967213115,0.950819672131147,0,0.0172413793103448,0.362068965517241,0.327586206896552,0.293103448275862,0.0491803278688525,0,0,0.333333333333333,0.333333333333333,0.333333333333333
"25011041000",2017,47,0,3,18,16,10,43,0,3,15,16,9,4,0,0,3,0,1,0,0.0638297872340425,0.382978723404255,0.340425531914894,0.212765957446809,0.914893617021277,0,0.0697674418604651,0.348837209302326,0.372093023255814,0.209302325581395,0.0851063829787234,0,0,0.75,0,0.25
"25011041100",2017,73,1,4,38,20,10,60,0,2,30,19,9,13,1,2,8,1,1,0.0136986301369863,0.0547945205479452,0.520547945205479,0.273972602739726,0.136986301369863,0.821917808219178,0,0.0333333333333333,0.5,0.316666666666667,0.15,0.178082191780822,0.0769230769230769,0.153846153846154,0.615384615384615,0.0769230769230769,0.0769230769230769
"25011041200",2017,38,1,3,25,7,2,35,1,2,24,7,1,3,0,1,1,0,1,0.0263157894736842,0.0789473684210526,0.657894736842105,0.184210526315789,0.0526315789473684,0.921052631578947,0.0285714285714286,0.0571428571428571,0.685714285714286,0.2,0.0285714285714286,0.0789473684210526,0,0.333333333333333,0.333333333333333,0,0.333333333333333
"25011041300",2017,37,0,6,18,10,3,31,0,6,15,8,2,6,0,0,3,2,1,0,0.162162162162162,0.486486486486487,0.27027027027027,0.0810810810810811,0.837837837837838,0,0.193548387096774,0.483870967741935,0.258064516129032,0.0645161290322581,0.162162162162162,0,0,0.5,0.333333333333333,0.166666666666667
"25011041400",2017,17,0,0,16,1,0,15,0,0,14,1,0,2,0,0,2,0,0,0,0,0.941176470588235,0.0588235294117647,0,0.882352941176471,0,0,0.933333333333333,0.0666666666666667,0,0.117647058823529,0,0,1,0,0
"25011041501",2017,36,0,6,12,11,7,31,0,4,11,9,7,5,0,2,1,2,0,0,0.166666666666667,0.333333333333333,0.305555555555556,0.194444444444444,0.861111111111111,0,0.129032258064516,0.354838709677419,0.290322580645161,0.225806451612903,0.138888888888889,0,0.4,0.2,0.4,0
"25011041502",2017,13,0,2,6,4,1,11,0,1,6,3,1,2,0,1,0,1,0,0,0.153846153846154,0.461538461538462,0.307692307692308,0.0769230769230769,0.846153846153846,0,0.0909090909090909,0.545454545454545,0.272727272727273,0.0909090909090909,0.153846153846154,0,0.5,0,0.5,0
"25013800101",2017,49,0,13,28,7,1,46,0,13,25,7,1,3,0,0,3,0,0,0,0.26530612244898,0.571428571428571,0.142857142857143,0.0204081632653061,0.938775510204082,0,0.282608695652174,0.543478260869565,0.152173913043478,0.0217391304347826,0.0612244897959184,0,0,1,0,0
"25013800102",2017,38,0,7,21,9,1,32,0,6,18,7,1,6,0,1,3,2,0,0,0.184210526315789,0.552631578947368,0.236842105263158,0.0263157894736842,0.842105263157895,0,0.1875,0.5625,0.21875,0.03125,0.157894736842105,0,0.166666666666667,0.5,0.333333333333333,0
"25013800201",2017,98,0,27,64,6,1,77,0,19,52,5,1,21,0,8,12,1,0,0,0.275510204081633,0.653061224489796,0.0612244897959184,0.0102040816326531,0.785714285714286,0,0.246753246753247,0.675324675324675,0.0649350649350649,0.012987012987013,0.214285714285714,0,0.380952380952381,0.571428571428571,0.0476190476190476,0
"25013800202",2017,36,2,9,22,3,0,13,0,3,9,1,0,23,2,6,13,2,0,0.0555555555555556,0.25,0.611111111111111,0.0833333333333333,0,0.361111111111111,0,0.230769230769231,0.692307692307692,0.0769230769230769,0,0.638888888888889,0.0869565217391304,0.260869565217391,0.565217391304348,0.0869565217391304,0
"25013800300",2017,112,1,25,69,11,6,93,0,21,57,10,5,19,1,4,12,1,1,0.00892857142857143,0.223214285714286,0.616071428571429,0.0982142857142857,0.0535714285714286,0.830357142857143,0,0.225806451612903,0.612903225806452,0.10752688172043,0.0537634408602151,0.169642857142857,0.0526315789473684,0.210526315789474,0.631578947368421,0.0526315789473684,0.0526315789473684
"25013800400",2017,78,0,18,54,5,1,66,0,14,46,5,1,12,0,4,8,0,0,0,0.230769230769231,0.692307692307692,0.0641025641025641,0.0128205128205128,0.846153846153846,0,0.212121212121212,0.696969696969697,0.0757575757575758,0.0151515151515152,0.153846153846154,0,0.333333333333333,0.666666666666667,0,0
"25013800500",2017,23,0,5,15,2,1,20,0,3,15,1,1,3,0,2,0,1,0,0,0.217391304347826,0.652173913043478,0.0869565217391304,0.0434782608695652,0.869565217391304,0,0.15,0.75,0.05,0.05,0.130434782608696,0,0.666666666666667,0,0.333333333333333,0
"25013800600",2017,4,1,2,0,1,0,3,0,2,0,1,0,1,1,0,0,0,0,0.25,0.5,0,0.25,0,0.75,0,0.666666666666667,0,0.333333333333333,0,0.25,1,0,0,0,0
"25013800700",2017,15,0,5,8,2,0,13,0,4,7,2,0,2,0,1,1,0,0,0,0.333333333333333,0.533333333333333,0.133333333333333,0,0.866666666666667,0,0.307692307692308,0.538461538461538,0.153846153846154,0,0.133333333333333,0,0.5,0.5,0,0
"25013800800",2017,2,0,0,2,0,0,2,0,0,2,0,0,0,0,0,0,0,0,0,0,1,0,0,1,0,0,1,0,0,0,0,0,0,0,0
"25013800900",2017,7,0,0,4,2,1,5,0,0,3,1,1,2,0,0,1,1,0,0,0,0.571428571428571,0.285714285714286,0.142857142857143,0.714285714285714,0,0,0.6,0.2,0.2,0.285714285714286,0,0,0.5,0.5,0
"25013801101",2017,2,0,1,1,0,0,2,0,1,1,0,0,0,0,0,0,0,0,0,0.5,0.5,0,0,1,0,0.5,0.5,0,0,0,0,0,0,0,0
"25013801102",2017,4,0,0,3,1,0,3,0,0,3,0,0,1,0,0,0,1,0,0,0,0.75,0.25,0,0.75,0,0,1,0,0,0.25,0,0,0,1,0
"25013801300",2017,38,0,7,19,6,6,26,0,4,13,5,4,12,0,3,6,1,2,0,0.184210526315789,0.5,0.157894736842105,0.157894736842105,0.684210526315789,0,0.153846153846154,0.5,0.192307692307692,0.153846153846154,0.315789473684211,0,0.25,0.5,0.0833333333333333,0.166666666666667
"25013801401",2017,27,0,3,23,1,0,18,0,3,14,1,0,9,0,0,9,0,0,0,0.111111111111111,0.851851851851852,0.037037037037037,0,0.666666666666667,0,0.166666666666667,0.777777777777778,0.0555555555555556,0,0.333333333333333,0,0,1,0,0
"25013801402",2017,28,1,13,11,2,1,22,1,9,10,2,0,6,0,4,1,0,1,0.0357142857142857,0.464285714285714,0.392857142857143,0.0714285714285714,0.0357142857142857,0.785714285714286,0.0454545454545455,0.409090909090909,0.454545454545455,0.0909090909090909,0,0.214285714285714,0,0.666666666666667,0.166666666666667,0,0.166666666666667
"25013801501",2017,74,1,14,46,10,3,67,1,13,40,10,3,7,0,1,6,0,0,0.0135135135135135,0.189189189189189,0.621621621621622,0.135135135135135,0.0405405405405405,0.905405405405405,0.0149253731343284,0.194029850746269,0.597014925373134,0.149253731343284,0.0447761194029851,0.0945945945945946,0,0.142857142857143,0.857142857142857,0,0
"25013801502",2017,36,0,12,21,2,1,29,0,7,20,2,0,7,0,5,1,0,1,0,0.333333333333333,0.583333333333333,0.0555555555555556,0.0277777777777778,0.805555555555556,0,0.241379310344828,0.689655172413793,0.0689655172413793,0,0.194444444444444,0,0.714285714285714,0.142857142857143,0,0.142857142857143
"25013801503",2017,55,1,11,38,4,1,45,1,9,31,4,0,10,0,2,7,0,1,0.0181818181818182,0.2,0.690909090909091,0.0727272727272727,0.0181818181818182,0.818181818181818,0.0222222222222222,0.2,0.688888888888889,0.0888888888888889,0,0.181818181818182,0,0.2,0.7,0,0.1
"25013801601",2017,65,0,6,41,15,3,53,0,5,34,11,3,12,0,1,7,4,0,0,0.0923076923076923,0.630769230769231,0.230769230769231,0.0461538461538462,0.815384615384615,0,0.0943396226415094,0.641509433962264,0.207547169811321,0.0566037735849057,0.184615384615385,0,0.0833333333333333,0.583333333333333,0.333333333333333,0
"25013801602",2017,67,0,9,46,11,1,59,0,7,41,10,1,8,0,2,5,1,0,0,0.134328358208955,0.686567164179104,0.164179104477612,0.0149253731343284,0.880597014925373,0,0.11864406779661,0.694915254237288,0.169491525423729,0.0169491525423729,0.119402985074627,0,0.25,0.625,0.125,0
"25013801603",2017,92,0,7,69,12,4,80,0,5,61,11,3,12,0,2,8,1,1,0,0.0760869565217391,0.75,0.130434782608696,0.0434782608695652,0.869565217391304,0,0.0625,0.7625,0.1375,0.0375,0.130434782608696,0,0.166666666666667,0.666666666666667,0.0833333333333333,0.0833333333333333
"25013801604",2017,73,0,9,56,8,0,68,0,7,53,8,0,5,0,2,3,0,0,0,0.123287671232877,0.767123287671233,0.10958904109589,0,0.931506849315068,0,0.102941176470588,0.779411764705882,0.117647058823529,0,0.0684931506849315,0,0.4,0.6,0,0
"25013801605",2017,54,0,2,32,18,2,47,0,2,27,16,2,7,0,0,5,2,0,0,0.037037037037037,0.592592592592593,0.333333333333333,0.037037037037037,0.87037037037037,0,0.0425531914893617,0.574468085106383,0.340425531914894,0.0425531914893617,0.12962962962963,0,0,0.714285714285714,0.285714285714286,0
"25013801700",2017,20,2,4,12,1,1,15,0,4,9,1,1,5,2,0,3,0,0,0.1,0.2,0.6,0.05,0.05,0.75,0,0.266666666666667,0.6,0.0666666666666667,0.0666666666666667,0.25,0.4,0,0.6,0,0
"25013801800",2017,20,0,9,11,0,0,17,0,8,9,0,0,3,0,1,2,0,0,0,0.45,0.55,0,0,0.85,0,0.470588235294118,0.529411764705882,0,0,0.15,0,0.333333333333333,0.666666666666667,0,0
"25013801901",2017,24,0,5,16,1,2,20,0,3,14,1,2,4,0,2,2,0,0,0,0.208333333333333,0.666666666666667,0.0416666666666667,0.0833333333333333,0.833333333333333,0,0.15,0.7,0.05,0.1,0.166666666666667,0,0.5,0.5,0,0
"25013801902",2017,12,0,2,8,2,0,10,0,1,7,2,0,2,0,1,1,0,0,0,0.166666666666667,0.666666666666667,0.166666666666667,0,0.833333333333333,0,0.1,0.7,0.2,0,0.166666666666667,0,0.5,0.5,0,0
"25013802000",2017,5,0,1,1,2,1,2,0,0,1,1,0,3,0,1,0,1,1,0,0.2,0.2,0.4,0.2,0.4,0,0,0.5,0.5,0,0.6,0,0.333333333333333,0,0.333333333333333,0.333333333333333
"25013802100",2017,48,1,5,24,14,4,37,0,3,19,12,3,11,1,2,5,2,1,0.0208333333333333,0.104166666666667,0.5,0.291666666666667,0.0833333333333333,0.770833333333333,0,0.0810810810810811,0.513513513513513,0.324324324324324,0.0810810810810811,0.229166666666667,0.0909090909090909,0.181818181818182,0.454545454545455,0.181818181818182,0.0909090909090909
"25013802200",2017,20,0,9,10,1,0,17,0,6,10,1,0,3,0,3,0,0,0,0,0.45,0.5,0.05,0,0.85,0,0.352941176470588,0.588235294117647,0.0588235294117647,0,0.15,0,1,0,0,0
"25013802300",2017,46,0,8,25,11,2,36,0,6,18,10,2,10,0,2,7,1,0,0,0.173913043478261,0.543478260869565,0.239130434782609,0.0434782608695652,0.782608695652174,0,0.166666666666667,0.5,0.277777777777778,0.0555555555555556,0.217391304347826,0,0.2,0.7,0.1,0
"25013802400",2017,90,0,16,58,13,3,82,0,14,52,13,3,8,0,2,6,0,0,0,0.177777777777778,0.644444444444444,0.144444444444444,0.0333333333333333,0.911111111111111,0,0.170731707317073,0.634146341463415,0.158536585365854,0.0365853658536585,0.0888888888888889,0,0.25,0.75,0,0
"25013802500",2017,179,0,21,126,24,8,159,0,15,115,22,7,20,0,6,11,2,1,0,0.11731843575419,0.70391061452514,0.134078212290503,0.0446927374301676,0.888268156424581,0,0.0943396226415094,0.723270440251572,0.138364779874214,0.0440251572327044,0.111731843575419,0,0.3,0.55,0.1,0.05
"25013802601",2017,96,0,13,66,9,8,83,0,8,59,8,8,13,0,5,7,1,0,0,0.135416666666667,0.6875,0.09375,0.0833333333333333,0.864583333333333,0,0.0963855421686747,0.710843373493976,0.0963855421686747,0.0963855421686747,0.135416666666667,0,0.384615384615385,0.538461538461538,0.0769230769230769,0
"25013802602",2017,42,0,1,28,10,3,40,0,1,26,10,3,2,0,0,2,0,0,0,0.0238095238095238,0.666666666666667,0.238095238095238,0.0714285714285714,0.952380952380952,0,0.025,0.65,0.25,0.075,0.0476190476190476,0,0,1,0,0
"25013810100",2017,87,1,4,50,27,5,77,0,3,42,27,5,10,1,1,8,0,0,0.0114942528735632,0.0459770114942529,0.574712643678161,0.310344827586207,0.0574712643678161,0.885057471264368,0,0.038961038961039,0.545454545454545,0.350649350649351,0.0649350649350649,0.114942528735632,0.1,0.1,0.8,0,0
"25013810200",2017,63,0,4,46,12,1,56,0,4,39,12,1,7,0,0,7,0,0,0,0.0634920634920635,0.73015873015873,0.19047619047619,0.0158730158730159,0.888888888888889,0,0.0714285714285714,0.696428571428571,0.214285714285714,0.0178571428571429,0.111111111111111,0,0,1,0,0
"25013810300",2017,36,0,2,23,8,3,34,0,2,21,8,3,2,0,0,2,0,0,0,0.0555555555555556,0.638888888888889,0.222222222222222,0.0833333333333333,0.944444444444444,0,0.0588235294117647,0.617647058823529,0.235294117647059,0.0882352941176471,0.0555555555555556,0,0,1,0,0
"25013810403",2017,33,0,4,22,5,2,31,0,4,21,5,1,2,0,0,1,0,1,0,0.121212121212121,0.666666666666667,0.151515151515152,0.0606060606060606,0.939393939393939,0,0.129032258064516,0.67741935483871,0.161290322580645,0.032258064516129,0.0606060606060606,0,0,0.5,0,0.5
"25013810404",2017,52,0,1,28,21,2,51,0,1,27,21,2,1,0,0,1,0,0,0,0.0192307692307692,0.538461538461538,0.403846153846154,0.0384615384615385,0.980769230769231,0,0.0196078431372549,0.529411764705882,0.411764705882353,0.0392156862745098,0.0192307692307692,0,0,1,0,0
"25013810412",2017,93,0,7,49,27,10,85,0,5,44,26,10,8,0,2,5,1,0,0,0.0752688172043011,0.526881720430108,0.290322580645161,0.10752688172043,0.913978494623656,0,0.0588235294117647,0.517647058823529,0.305882352941176,0.117647058823529,0.0860215053763441,0,0.25,0.625,0.125,0
"25013810414",2017,69,0,3,21,26,19,59,0,0,19,24,16,10,0,3,2,2,3,0,0.0434782608695652,0.304347826086957,0.376811594202899,0.27536231884058,0.855072463768116,0,0,0.322033898305085,0.406779661016949,0.271186440677966,0.144927536231884,0,0.3,0.2,0.2,0.3
"25013810601",2017,56,1,4,41,7,3,46,0,4,34,5,3,10,1,0,7,2,0,0.0178571428571429,0.0714285714285714,0.732142857142857,0.125,0.0535714285714286,0.821428571428571,0,0.0869565217391304,0.739130434782609,0.108695652173913,0.0652173913043478,0.178571428571429,0.1,0,0.7,0.2,0
"25013810602",2017,31,0,2,18,6,5,28,0,2,15,6,5,3,0,0,3,0,0,0,0.0645161290322581,0.580645161290323,0.193548387096774,0.161290322580645,0.903225806451613,0,0.0714285714285714,0.535714285714286,0.214285714285714,0.178571428571429,0.0967741935483871,0,0,1,0,0
"25013810700",2017,98,0,11,67,18,2,85,0,6,62,16,1,13,0,5,5,2,1,0,0.112244897959184,0.683673469387755,0.183673469387755,0.0204081632653061,0.86734693877551,0,0.0705882352941176,0.729411764705882,0.188235294117647,0.0117647058823529,0.13265306122449,0,0.384615384615385,0.384615384615385,0.153846153846154,0.0769230769230769
"25013810800",2017,39,0,3,24,6,6,36,0,2,23,6,5,3,0,1,1,0,1,0,0.0769230769230769,0.615384615384615,0.153846153846154,0.153846153846154,0.923076923076923,0,0.0555555555555556,0.638888888888889,0.166666666666667,0.138888888888889,0.0769230769230769,0,0.333333333333333,0.333333333333333,0,0.333333333333333
"25013810901",2017,10,1,0,7,2,0,10,1,0,7,2,0,0,0,0,0,0,0,0.1,0,0.7,0.2,0,1,0.1,0,0.7,0.2,0,0,0,0,0,0,0
"25013810902",2017,46,0,6,27,10,3,41,0,4,26,8,3,5,0,2,1,2,0,0,0.130434782608696,0.58695652173913,0.217391304347826,0.0652173913043478,0.891304347826087,0,0.0975609756097561,0.634146341463415,0.195121951219512,0.0731707317073171,0.108695652173913,0,0.4,0.2,0.4,0
"25013811000",2017,72,0,4,49,16,3,63,0,2,43,15,3,9,0,2,6,1,0,0,0.0555555555555556,0.680555555555556,0.222222222222222,0.0416666666666667,0.875,0,0.0317460317460317,0.682539682539683,0.238095238095238,0.0476190476190476,0.125,0,0.222222222222222,0.666666666666667,0.111111111111111,0
"25013811101",2017,38,1,7,27,2,1,32,1,6,23,1,1,6,0,1,4,1,0,0.0263157894736842,0.184210526315789,0.710526315789474,0.0526315789473684,0.0263157894736842,0.842105263157895,0.03125,0.1875,0.71875,0.03125,0.03125,0.157894736842105,0,0.166666666666667,0.666666666666667,0.166666666666667,0
"25013811102",2017,57,0,9,36,12,0,52,0,8,35,9,0,5,0,1,1,3,0,0,0.157894736842105,0.631578947368421,0.210526315789474,0,0.912280701754386,0,0.153846153846154,0.673076923076923,0.173076923076923,0,0.087719298245614,0,0.2,0.2,0.6,0
"25013811200",2017,58,0,4,34,14,6,49,0,2,31,11,5,9,0,2,3,3,1,0,0.0689655172413793,0.586206896551724,0.241379310344828,0.103448275862069,0.844827586206897,0,0.0408163265306122,0.63265306122449,0.224489795918367,0.102040816326531,0.155172413793103,0,0.222222222222222,0.333333333333333,0.333333333333333,0.111111111111111
"25013811301",2017,62,0,3,43,14,2,54,0,2,36,14,2,8,0,1,7,0,0,0,0.0483870967741935,0.693548387096774,0.225806451612903,0.032258064516129,0.870967741935484,0,0.037037037037037,0.666666666666667,0.259259259259259,0.037037037037037,0.129032258064516,0,0.125,0.875,0,0
"25013811302",2017,102,0,8,71,18,5,92,0,7,62,18,5,10,0,1,9,0,0,0,0.0784313725490196,0.696078431372549,0.176470588235294,0.0490196078431373,0.901960784313726,0,0.0760869565217391,0.673913043478261,0.195652173913043,0.0543478260869565,0.0980392156862745,0,0.1,0.9,0,0
"25013811400",2017,5,0,1,3,0,1,4,0,1,2,0,1,1,0,0,1,0,0,0,0.2,0.6,0,0.2,0.8,0,0.25,0.5,0,0.25,0.2,0,0,1,0,0
"25013811500",2017,2,0,1,0,0,1,2,0,1,0,0,1,0,0,0,0,0,0,0,0.5,0,0,0.5,1,0,0.5,0,0,0.5,0,0,0,0,0,0
"25013811600",2017,6,0,1,5,0,0,4,0,1,3,0,0,2,0,0,2,0,0,0,0.166666666666667,0.833333333333333,0,0,0.666666666666667,0,0.25,0.75,0,0,0.333333333333333,0,0,1,0,0
"25013811700",2017,14,1,1,9,2,1,11,0,1,8,1,1,3,1,0,1,1,0,0.0714285714285714,0.0714285714285714,0.642857142857143,0.142857142857143,0.0714285714285714,0.785714285714286,0,0.0909090909090909,0.727272727272727,0.0909090909090909,0.0909090909090909,0.214285714285714,0.333333333333333,0,0.333333333333333,0.333333333333333,0
"25013811800",2017,28,1,3,17,4,3,22,0,0,16,4,2,6,1,3,1,0,1,0.0357142857142857,0.107142857142857,0.607142857142857,0.142857142857143,0.107142857142857,0.785714285714286,0,0,0.727272727272727,0.181818181818182,0.0909090909090909,0.214285714285714,0.166666666666667,0.5,0.166666666666667,0,0.166666666666667
"25013811900",2017,53,0,1,17,23,12,49,0,0,15,22,12,4,0,1,2,1,0,0,0.0188679245283019,0.320754716981132,0.433962264150943,0.226415094339623,0.924528301886792,0,0,0.306122448979592,0.448979591836735,0.244897959183673,0.0754716981132075,0,0.25,0.5,0.25,0
"25013812001",2017,25,0,0,14,9,2,22,0,0,11,9,2,3,0,0,3,0,0,0,0,0.56,0.36,0.08,0.88,0,0,0.5,0.409090909090909,0.0909090909090909,0.12,0,0,1,0,0
"25013812002",2017,38,0,2,27,9,0,36,0,2,25,9,0,2,0,0,2,0,0,0,0.0526315789473684,0.710526315789474,0.236842105263158,0,0.947368421052632,0,0.0555555555555556,0.694444444444444,0.25,0,0.0526315789473684,0,0,1,0,0
"25013812101",2017,71,0,6,42,19,4,64,0,3,39,19,3,7,0,3,3,0,1,0,0.0845070422535211,0.591549295774648,0.267605633802817,0.0563380281690141,0.901408450704225,0,0.046875,0.609375,0.296875,0.046875,0.0985915492957746,0,0.428571428571429,0.428571428571429,0,0.142857142857143
"25013812103",2017,11,0,2,7,2,0,11,0,2,7,2,0,0,0,0,0,0,0,0,0.181818181818182,0.636363636363636,0.181818181818182,0,1,0,0.181818181818182,0.636363636363636,0.181818181818182,0,0,0,0,0,0,0
"25013812104",2017,44,0,5,31,7,1,40,0,5,27,7,1,4,0,0,4,0,0,0,0.113636363636364,0.704545454545455,0.159090909090909,0.0227272727272727,0.909090909090909,0,0.125,0.675,0.175,0.025,0.0909090909090909,0,0,1,0,0
"25013812201",2017,56,0,5,38,8,5,48,0,4,31,8,5,8,0,1,7,0,0,0,0.0892857142857143,0.678571428571429,0.142857142857143,0.0892857142857143,0.857142857142857,0,0.0833333333333333,0.645833333333333,0.166666666666667,0.104166666666667,0.142857142857143,0,0.125,0.875,0,0
"25013812202",2017,32,0,2,15,8,7,26,0,2,13,5,6,6,0,0,2,3,1,0,0.0625,0.46875,0.25,0.21875,0.8125,0,0.0769230769230769,0.5,0.192307692307692,0.230769230769231,0.1875,0,0,0.333333333333333,0.5,0.166666666666667
"25013812300",2017,34,1,4,22,3,4,30,0,3,20,3,4,4,1,1,2,0,0,0.0294117647058824,0.117647058823529,0.647058823529412,0.0882352941176471,0.117647058823529,0.882352941176471,0,0.1,0.666666666666667,0.1,0.133333333333333,0.117647058823529,0.25,0.25,0.5,0,0
"25013812401",2017,87,0,2,39,31,15,83,0,2,38,30,13,4,0,0,1,1,2,0,0.0229885057471264,0.448275862068966,0.35632183908046,0.172413793103448,0.954022988505747,0,0.0240963855421687,0.457831325301205,0.36144578313253,0.156626506024096,0.0459770114942529,0,0,0.25,0.25,0.5
"25013812403",2017,63,0,6,47,7,3,58,0,4,45,7,2,5,0,2,2,0,1,0,0.0952380952380952,0.746031746031746,0.111111111111111,0.0476190476190476,0.920634920634921,0,0.0689655172413793,0.775862068965517,0.120689655172414,0.0344827586206897,0.0793650793650794,0,0.4,0.4,0,0.2
"25013812404",2017,51,0,4,22,21,4,47,0,4,20,19,4,4,0,0,2,2,0,0,0.0784313725490196,0.431372549019608,0.411764705882353,0.0784313725490196,0.92156862745098,0,0.0851063829787234,0.425531914893617,0.404255319148936,0.0851063829787234,0.0784313725490196,0,0,0.5,0.5,0
"25013812500",2017,88,0,2,46,26,14,75,0,1,40,20,14,13,0,1,6,6,0,0,0.0227272727272727,0.522727272727273,0.295454545454545,0.159090909090909,0.852272727272727,0,0.0133333333333333,0.533333333333333,0.266666666666667,0.186666666666667,0.147727272727273,0,0.0769230769230769,0.461538461538462,0.461538461538462,0
"25013812600",2017,76,1,1,29,27,18,71,0,1,27,26,17,5,1,0,2,1,1,0.0131578947368421,0.0131578947368421,0.381578947368421,0.355263157894737,0.236842105263158,0.934210526315789,0,0.0140845070422535,0.380281690140845,0.366197183098592,0.23943661971831,0.0657894736842105,0.2,0,0.4,0.2,0.2
"25013812701",2017,30,0,0,19,11,0,29,0,0,18,11,0,1,0,0,1,0,0,0,0,0.633333333333333,0.366666666666667,0,0.966666666666667,0,0,0.620689655172414,0.379310344827586,0,0.0333333333333333,0,0,1,0,0
"25013812702",2017,28,0,1,16,7,4,26,0,1,15,6,4,2,0,0,1,1,0,0,0.0357142857142857,0.571428571428571,0.25,0.142857142857143,0.928571428571429,0,0.0384615384615385,0.576923076923077,0.230769230769231,0.153846153846154,0.0714285714285714,0,0,0.5,0.5,0
"25013812800",2017,97,0,4,49,32,12,89,0,3,45,29,12,8,0,1,4,3,0,0,0.0412371134020619,0.505154639175258,0.329896907216495,0.123711340206186,0.917525773195876,0,0.0337078651685393,0.50561797752809,0.325842696629214,0.134831460674157,0.0824742268041237,0,0.125,0.5,0.375,0
"25013812901",2017,60,0,0,35,17,8,54,0,0,29,17,8,6,0,0,6,0,0,0,0,0.583333333333333,0.283333333333333,0.133333333333333,0.9,0,0,0.537037037037037,0.314814814814815,0.148148148148148,0.1,0,0,1,0,0
"25013812902",2017,64,0,6,24,22,12,63,0,6,24,21,12,1,0,0,0,1,0,0,0.09375,0.375,0.34375,0.1875,0.984375,0,0.0952380952380952,0.380952380952381,0.333333333333333,0.19047619047619,0.015625,0,0,0,1,0
"25013813000",2017,105,0,9,54,27,15,87,0,6,45,24,12,18,0,3,9,3,3,0,0.0857142857142857,0.514285714285714,0.257142857142857,0.142857142857143,0.828571428571429,0,0.0689655172413793,0.517241379310345,0.275862068965517,0.137931034482759,0.171428571428571,0,0.166666666666667,0.5,0.166666666666667,0.166666666666667
"25013813101",2017,87,0,4,26,38,19,78,0,4,22,33,19,9,0,0,4,5,0,0,0.0459770114942529,0.298850574712644,0.436781609195402,0.218390804597701,0.896551724137931,0,0.0512820512820513,0.282051282051282,0.423076923076923,0.243589743589744,0.103448275862069,0,0,0.444444444444444,0.555555555555556,0
"25013813102",2017,40,0,0,15,15,10,38,0,0,13,15,10,2,0,0,2,0,0,0,0,0.375,0.375,0.25,0.95,0,0,0.342105263157895,0.394736842105263,0.263157894736842,0.05,0,0,1,0,0
"25013813204",2017,43,0,1,13,21,8,38,0,0,10,20,8,5,0,1,3,1,0,0,0.0232558139534884,0.302325581395349,0.488372093023256,0.186046511627907,0.883720930232558,0,0,0.263157894736842,0.526315789473684,0.210526315789474,0.116279069767442,0,0.2,0.6,0.2,0
"25013813205",2017,92,0,5,40,34,13,86,0,5,36,32,13,6,0,0,4,2,0,0,0.0543478260869565,0.434782608695652,0.369565217391304,0.141304347826087,0.934782608695652,0,0.0581395348837209,0.418604651162791,0.372093023255814,0.151162790697674,0.0652173913043478,0,0,0.666666666666667,0.333333333333333,0
"25013813206",2017,34,0,3,17,13,1,32,0,2,17,12,1,2,0,1,0,1,0,0,0.0882352941176471,0.5,0.382352941176471,0.0294117647058824,0.941176470588235,0,0.0625,0.53125,0.375,0.03125,0.0588235294117647,0,0.5,0,0.5,0
"25013813207",2017,44,0,4,24,13,3,42,0,4,22,13,3,2,0,0,2,0,0,0,0.0909090909090909,0.545454545454545,0.295454545454545,0.0681818181818182,0.954545454545455,0,0.0952380952380952,0.523809523809524,0.30952380952381,0.0714285714285714,0.0454545454545455,0,0,1,0,0
"25013813208",2017,39,0,2,21,15,1,33,0,0,18,15,0,6,0,2,3,0,1,0,0.0512820512820513,0.538461538461538,0.384615384615385,0.0256410256410256,0.846153846153846,0,0,0.545454545454545,0.454545454545455,0,0.153846153846154,0,0.333333333333333,0.5,0,0.166666666666667
"25013813209",2017,76,0,8,41,21,6,67,0,5,39,18,5,9,0,3,2,3,1,0,0.105263157894737,0.539473684210526,0.276315789473684,0.0789473684210526,0.881578947368421,0,0.0746268656716418,0.582089552238806,0.26865671641791,0.0746268656716418,0.118421052631579,0,0.333333333333333,0.222222222222222,0.333333333333333,0.111111111111111
"25013813301",2017,112,0,0,25,41,46,105,0,0,22,38,45,7,0,0,3,3,1,0,0,0.223214285714286,0.366071428571429,0.410714285714286,0.9375,0,0,0.20952380952381,0.361904761904762,0.428571428571429,0.0625,0,0,0.428571428571429,0.428571428571429,0.142857142857143
"25013813303",2017,78,0,1,12,12,53,74,0,1,10,10,53,4,0,0,2,2,0,0,0.0128205128205128,0.153846153846154,0.153846153846154,0.67948717948718,0.948717948717949,0,0.0135135135135135,0.135135135135135,0.135135135135135,0.716216216216216,0.0512820512820513,0,0,0.5,0.5,0
"25013813304",2017,58,0,0,11,17,30,55,0,0,10,17,28,3,0,0,1,0,2,0,0,0.189655172413793,0.293103448275862,0.517241379310345,0.948275862068966,0,0,0.181818181818182,0.309090909090909,0.509090909090909,0.0517241379310345,0,0,0.333333333333333,0,0.666666666666667
"25013813401",2017,94,0,5,39,37,13,86,0,3,35,35,13,8,0,2,4,2,0,0,0.0531914893617021,0.414893617021277,0.393617021276596,0.138297872340426,0.914893617021277,0,0.0348837209302326,0.406976744186047,0.406976744186047,0.151162790697674,0.0851063829787234,0,0.25,0.5,0.25,0
"25013813403",2017,61,0,0,23,24,14,57,0,0,22,22,13,4,0,0,1,2,1,0,0,0.377049180327869,0.39344262295082,0.229508196721311,0.934426229508197,0,0,0.385964912280702,0.385964912280702,0.228070175438596,0.0655737704918033,0,0,0.25,0.5,0.25
"25013813404",2017,106,0,3,30,29,44,97,0,3,27,25,42,9,0,0,3,4,2,0,0.0283018867924528,0.283018867924528,0.273584905660377,0.415094339622642,0.915094339622642,0,0.0309278350515464,0.278350515463918,0.257731958762887,0.43298969072165,0.0849056603773585,0,0,0.333333333333333,0.444444444444444,0.222222222222222
"25013813500",2017,66,0,0,21,23,22,62,0,0,19,21,22,4,0,0,2,2,0,0,0,0.318181818181818,0.348484848484849,0.333333333333333,0.939393939393939,0,0,0.306451612903226,0.338709677419355,0.354838709677419,0.0606060606060606,0,0,0.5,0.5,0
"25013813601",2017,125,0,2,37,49,37,111,0,2,30,46,33,14,0,0,7,3,4,0,0.016,0.296,0.392,0.296,0.888,0,0.018018018018018,0.27027027027027,0.414414414414414,0.297297297297297,0.112,0,0,0.5,0.214285714285714,0.285714285714286
"25013813602",2017,107,0,1,23,39,44,101,0,1,23,36,41,6,0,0,0,3,3,0,0.00934579439252336,0.214953271028037,0.364485981308411,0.411214953271028,0.94392523364486,0,0.0099009900990099,0.227722772277228,0.356435643564356,0.405940594059406,0.0560747663551402,0,0,0,0.5,0.5
"25013813701",2017,55,0,3,25,22,5,48,0,3,22,18,5,7,0,0,3,4,0,0,0.0545454545454545,0.454545454545455,0.4,0.0909090909090909,0.872727272727273,0,0.0625,0.458333333333333,0.375,0.104166666666667,0.127272727272727,0,0,0.428571428571429,0.571428571428571,0
"25013813702",2017,75,0,3,35,26,11,66,0,3,30,23,10,9,0,0,5,3,1,0,0.04,0.466666666666667,0.346666666666667,0.146666666666667,0.88,0,0.0454545454545455,0.454545454545455,0.348484848484849,0.151515151515152,0.12,0,0,0.555555555555556,0.333333333333333,0.111111111111111
"25013813801",2017,90,0,3,42,23,22,80,0,1,36,22,21,10,0,2,6,1,1,0,0.0333333333333333,0.466666666666667,0.255555555555556,0.244444444444444,0.888888888888889,0,0.0125,0.45,0.275,0.2625,0.111111111111111,0,0.2,0.6,0.1,0.1
"25013813802",2017,43,0,3,17,14,9,39,0,1,17,14,7,4,0,2,0,0,2,0,0.0697674418604651,0.395348837209302,0.325581395348837,0.209302325581395,0.906976744186046,0,0.0256410256410256,0.435897435897436,0.358974358974359,0.179487179487179,0.0930232558139535,0,0.5,0,0,0.5
"25015820101",2017,99,1,9,51,28,10,85,0,6,41,28,10,14,1,3,10,0,0,0.0101010101010101,0.0909090909090909,0.515151515151515,0.282828282828283,0.101010101010101,0.858585858585859,0,0.0705882352941176,0.482352941176471,0.329411764705882,0.117647058823529,0.141414141414141,0.0714285714285714,0.214285714285714,0.714285714285714,0,0
"25015820102",2017,47,0,7,34,5,1,42,0,5,31,5,1,5,0,2,3,0,0,0,0.148936170212766,0.723404255319149,0.106382978723404,0.0212765957446809,0.893617021276596,0,0.119047619047619,0.738095238095238,0.119047619047619,0.0238095238095238,0.106382978723404,0,0.4,0.6,0,0
"25015820202",2017,14,0,0,3,5,6,11,0,0,2,3,6,3,0,0,1,2,0,0,0,0.214285714285714,0.357142857142857,0.428571428571429,0.785714285714286,0,0,0.181818181818182,0.272727272727273,0.545454545454545,0.214285714285714,0,0,0.333333333333333,0.666666666666667,0
"25015820203",2017,115,1,3,43,44,24,104,0,3,39,39,23,11,1,0,4,5,1,0.00869565217391304,0.0260869565217391,0.373913043478261,0.382608695652174,0.208695652173913,0.904347826086957,0,0.0288461538461538,0.375,0.375,0.221153846153846,0.0956521739130435,0.0909090909090909,0,0.363636363636364,0.454545454545455,0.0909090909090909
"25015820204",2017,109,0,1,40,48,20,100,0,1,35,46,18,9,0,0,5,2,2,0,0.00917431192660551,0.36697247706422,0.440366972477064,0.18348623853211,0.917431192660551,0,0.01,0.35,0.46,0.18,0.0825688073394495,0,0,0.555555555555556,0.222222222222222,0.222222222222222
"25015820300",2017,47,0,0,2,22,23,41,0,0,0,19,22,6,0,0,2,3,1,0,0,0.0425531914893617,0.468085106382979,0.48936170212766,0.872340425531915,0,0,0,0.463414634146341,0.536585365853659,0.127659574468085,0,0,0.333333333333333,0.5,0.166666666666667
"25015820500",2017,42,0,1,18,5,18,37,0,1,17,4,15,5,0,0,1,1,3,0,0.0238095238095238,0.428571428571429,0.119047619047619,0.428571428571429,0.880952380952381,0,0.027027027027027,0.459459459459459,0.108108108108108,0.405405405405405,0.119047619047619,0,0,0.2,0.2,0.6
"25015820600",2017,2,0,0,0,0,2,2,0,0,0,0,2,0,0,0,0,0,0,0,0,0,0,1,1,0,0,0,0,1,0,0,0,0,0,0
"25015820700",2017,49,0,2,12,11,24,45,0,1,11,11,22,4,0,1,1,0,2,0,0.0408163265306122,0.244897959183673,0.224489795918367,0.489795918367347,0.918367346938776,0,0.0222222222222222,0.244444444444444,0.244444444444444,0.488888888888889,0.0816326530612245,0,0.25,0.25,0,0.5
"25015820801",2017,43,0,1,9,19,14,42,0,1,8,19,14,1,0,0,1,0,0,0,0.0232558139534884,0.209302325581395,0.441860465116279,0.325581395348837,0.976744186046512,0,0.0238095238095238,0.19047619047619,0.452380952380952,0.333333333333333,0.0232558139534884,0,0,1,0,0
"25015820900",2017,86,0,3,33,31,19,78,0,2,30,29,17,8,0,1,3,2,2,0,0.0348837209302326,0.383720930232558,0.36046511627907,0.22093023255814,0.906976744186046,0,0.0256410256410256,0.384615384615385,0.371794871794872,0.217948717948718,0.0930232558139535,0,0.125,0.375,0.25,0.25
"25015821000",2017,73,1,1,44,14,13,63,0,0,39,13,11,10,1,1,5,1,2,0.0136986301369863,0.0136986301369863,0.602739726027397,0.191780821917808,0.178082191780822,0.863013698630137,0,0,0.619047619047619,0.206349206349206,0.174603174603175,0.136986301369863,0.1,0.1,0.5,0.1,0.2
"25015821100",2017,93,0,3,49,30,11,87,0,2,44,30,11,6,0,1,5,0,0,0,0.032258064516129,0.526881720430108,0.32258064516129,0.118279569892473,0.935483870967742,0,0.0229885057471264,0.505747126436782,0.344827586206897,0.126436781609195,0.0645161290322581,0,0.166666666666667,0.833333333333333,0,0
"25015821200",2017,2,0,0,0,1,1,2,0,0,0,1,1,0,0,0,0,0,0,0,0,0,0.5,0.5,1,0,0,0,0.5,0.5,0,0,0,0,0,0
"25015821300",2017,51,0,1,19,18,13,48,0,1,17,17,13,3,0,0,2,1,0,0,0.0196078431372549,0.372549019607843,0.352941176470588,0.254901960784314,0.941176470588235,0,0.0208333333333333,0.354166666666667,0.354166666666667,0.270833333333333,0.0588235294117647,0,0,0.666666666666667,0.333333333333333,0
"25015821400",2017,44,0,1,10,15,18,37,0,1,9,11,16,7,0,0,1,4,2,0,0.0227272727272727,0.227272727272727,0.340909090909091,0.409090909090909,0.840909090909091,0,0.027027027027027,0.243243243243243,0.297297297297297,0.432432432432432,0.159090909090909,0,0,0.142857142857143,0.571428571428571,0.285714285714286
"25015821500",2017,51,0,1,12,23,15,48,0,1,10,22,15,3,0,0,2,1,0,0,0.0196078431372549,0.235294117647059,0.450980392156863,0.294117647058824,0.941176470588235,0,0.0208333333333333,0.208333333333333,0.458333333333333,0.3125,0.0588235294117647,0,0,0.666666666666667,0.333333333333333,0
"25015821601",2017,36,0,2,11,14,9,34,0,2,10,13,9,2,0,0,1,1,0,0,0.0555555555555556,0.305555555555556,0.388888888888889,0.25,0.944444444444444,0,0.0588235294117647,0.294117647058824,0.382352941176471,0.264705882352941,0.0555555555555556,0,0,0.5,0.5,0
"25015821602",2017,39,0,1,10,17,11,35,0,0,10,15,10,4,0,1,0,2,1,0,0.0256410256410256,0.256410256410256,0.435897435897436,0.282051282051282,0.897435897435897,0,0,0.285714285714286,0.428571428571429,0.285714285714286,0.102564102564103,0,0.25,0,0.5,0.25
"25015821700",2017,55,0,1,21,19,14,54,0,1,20,19,14,1,0,0,1,0,0,0,0.0181818181818182,0.381818181818182,0.345454545454545,0.254545454545455,0.981818181818182,0,0.0185185185185185,0.37037037037037,0.351851851851852,0.259259259259259,0.0181818181818182,0,0,1,0,0
"25015821901",2017,28,0,1,4,6,17,25,0,0,4,5,16,3,0,1,0,1,1,0,0.0357142857142857,0.142857142857143,0.214285714285714,0.607142857142857,0.892857142857143,0,0,0.16,0.2,0.64,0.107142857142857,0,0.333333333333333,0,0.333333333333333,0.333333333333333
"25015821903",2017,34,0,0,13,8,13,33,0,0,12,8,13,1,0,0,1,0,0,0,0,0.382352941176471,0.235294117647059,0.382352941176471,0.970588235294118,0,0,0.363636363636364,0.242424242424242,0.393939393939394,0.0294117647058824,0,0,1,0,0
"25015821904",2017,16,0,0,5,8,3,14,0,0,4,8,2,2,0,0,1,0,1,0,0,0.3125,0.5,0.1875,0.875,0,0,0.285714285714286,0.571428571428571,0.142857142857143,0.125,0,0,0.5,0,0.5
"25015822200",2017,83,1,3,25,23,31,78,0,2,25,21,30,5,1,1,0,2,1,0.0120481927710843,0.036144578313253,0.301204819277108,0.27710843373494,0.373493975903614,0.939759036144578,0,0.0256410256410256,0.320512820512821,0.269230769230769,0.384615384615385,0.0602409638554217,0.2,0.2,0,0.4,0.2
"25015822300",2017,50,0,3,17,17,13,45,0,2,13,17,13,5,0,1,4,0,0,0,0.06,0.34,0.34,0.26,0.9,0,0.0444444444444444,0.288888888888889,0.377777777777778,0.288888888888889,0.1,0,0.2,0.8,0,0
"25015822401",2017,77,0,1,26,32,18,72,0,1,25,30,16,5,0,0,1,2,2,0,0.012987012987013,0.337662337662338,0.415584415584416,0.233766233766234,0.935064935064935,0,0.0138888888888889,0.347222222222222,0.416666666666667,0.222222222222222,0.0649350649350649,0,0,0.2,0.4,0.4
"25015822402",2017,44,0,1,17,16,10,41,0,1,17,14,9,3,0,0,0,2,1,0,0.0227272727272727,0.386363636363636,0.363636363636364,0.227272727272727,0.931818181818182,0,0.024390243902439,0.414634146341463,0.341463414634146,0.219512195121951,0.0681818181818182,0,0,0,0.666666666666667,0.333333333333333
"25015822500",2017,73,0,2,24,24,23,67,0,1,23,22,21,6,0,1,1,2,2,0,0.0273972602739726,0.328767123287671,0.328767123287671,0.315068493150685,0.917808219178082,0,0.0149253731343284,0.343283582089552,0.328358208955224,0.313432835820896,0.0821917808219178,0,0.166666666666667,0.166666666666667,0.333333333333333,0.333333333333333
"25015822601",2017,31,0,1,16,14,0,29,0,1,14,14,0,2,0,0,2,0,0,0,0.032258064516129,0.516129032258065,0.451612903225806,0,0.935483870967742,0,0.0344827586206897,0.482758620689655,0.482758620689655,0,0.0645161290322581,0,0,1,0,0
"25015822603",2017,18,0,2,5,6,5,17,0,1,5,6,5,1,0,1,0,0,0,0,0.111111111111111,0.277777777777778,0.333333333333333,0.277777777777778,0.944444444444444,0,0.0588235294117647,0.294117647058824,0.352941176470588,0.294117647058824,0.0555555555555556,0,1,0,0,0
"25015822605",2017,12,0,0,5,5,2,12,0,0,5,5,2,0,0,0,0,0,0,0,0,0.416666666666667,0.416666666666667,0.166666666666667,1,0,0,0.416666666666667,0.416666666666667,0.166666666666667,0,0,0,0,0,0
"25015822606",2017,53,0,0,14,19,20,45,0,0,12,15,18,8,0,0,2,4,2,0,0,0.264150943396226,0.358490566037736,0.377358490566038,0.849056603773585,0,0,0.266666666666667,0.333333333333333,0.4,0.150943396226415,0,0,0.25,0.5,0.25
"25015822700",2017,39,0,1,21,13,4,36,0,1,21,10,4,3,0,0,0,3,0,0,0.0256410256410256,0.538461538461538,0.333333333333333,0.102564102564103,0.923076923076923,0,0.0277777777777778,0.583333333333333,0.277777777777778,0.111111111111111,0.0769230769230769,0,0,0,1,0
"25017300100",2017,48,0,1,19,23,5,41,0,1,17,18,5,7,0,0,2,5,0,0,0.0208333333333333,0.395833333333333,0.479166666666667,0.104166666666667,0.854166666666667,0,0.024390243902439,0.414634146341463,0.439024390243902,0.121951219512195,0.145833333333333,0,0,0.285714285714286,0.714285714285714,0
"25017301101",2017,77,0,4,28,29,16,66,0,2,22,28,14,11,0,2,6,1,2,0,0.051948051948052,0.363636363636364,0.376623376623377,0.207792207792208,0.857142857142857,0,0.0303030303030303,0.333333333333333,0.424242424242424,0.212121212121212,0.142857142857143,0,0.181818181818182,0.545454545454545,0.0909090909090909,0.181818181818182
"25017301102",2017,75,0,0,26,34,15,69,0,0,22,33,14,6,0,0,4,1,1,0,0,0.346666666666667,0.453333333333333,0.2,0.92,0,0,0.318840579710145,0.478260869565217,0.202898550724638,0.08,0,0,0.666666666666667,0.166666666666667,0.166666666666667
"25017310100",2017,66,0,0,21,25,20,58,0,0,20,21,17,8,0,0,1,4,3,0,0,0.318181818181818,0.378787878787879,0.303030303030303,0.878787878787879,0,0,0.344827586206897,0.362068965517241,0.293103448275862,0.121212121212121,0,0,0.125,0.5,0.375
"25017310200",2017,100,0,4,55,31,10,84,0,2,43,30,9,16,0,2,12,1,1,0,0.04,0.55,0.31,0.1,0.84,0,0.0238095238095238,0.511904761904762,0.357142857142857,0.107142857142857,0.16,0,0.125,0.75,0.0625,0.0625
"25017310300",2017,81,1,2,48,28,2,70,1,2,40,26,1,11,0,0,8,2,1,0.0123456790123457,0.0246913580246914,0.592592592592593,0.345679012345679,0.0246913580246914,0.864197530864197,0.0142857142857143,0.0285714285714286,0.571428571428571,0.371428571428571,0.0142857142857143,0.135802469135802,0,0,0.727272727272727,0.181818181818182,0.0909090909090909
"25017310400",2017,42,0,4,30,5,3,36,0,4,24,5,3,6,0,0,6,0,0,0,0.0952380952380952,0.714285714285714,0.119047619047619,0.0714285714285714,0.857142857142857,0,0.111111111111111,0.666666666666667,0.138888888888889,0.0833333333333333,0.142857142857143,0,0,1,0,0
"25017310500",2017,19,0,1,12,2,4,18,0,1,12,2,3,1,0,0,0,0,1,0,0.0526315789473684,0.631578947368421,0.105263157894737,0.210526315789474,0.947368421052632,0,0.0555555555555556,0.666666666666667,0.111111111111111,0.166666666666667,0.0526315789473684,0,0,0,0,1
"25017310601",2017,67,0,2,24,26,15,60,0,1,21,24,14,7,0,1,3,2,1,0,0.0298507462686567,0.358208955223881,0.388059701492537,0.223880597014925,0.895522388059702,0,0.0166666666666667,0.35,0.4,0.233333333333333,0.104477611940299,0,0.142857142857143,0.428571428571429,0.285714285714286,0.142857142857143
"25017310602",2017,81,2,5,38,25,11,70,1,3,33,23,10,11,1,2,5,2,1,0.0246913580246914,0.0617283950617284,0.469135802469136,0.308641975308642,0.135802469135802,0.864197530864197,0.0142857142857143,0.0428571428571429,0.471428571428571,0.328571428571429,0.142857142857143,0.135802469135802,0.0909090909090909,0.181818181818182,0.454545454545455,0.181818181818182,0.0909090909090909
"25017310700",2017,29,0,3,14,9,3,25,0,2,12,8,3,4,0,1,2,1,0,0,0.103448275862069,0.482758620689655,0.310344827586207,0.103448275862069,0.862068965517241,0,0.08,0.48,0.32,0.12,0.137931034482759,0,0.25,0.5,0.25,0
"25017311100",2017,12,1,0,8,1,2,10,1,0,7,1,1,2,0,0,1,0,1,0.0833333333333333,0,0.666666666666667,0.0833333333333333,0.166666666666667,0.833333333333333,0.1,0,0.7,0.1,0.1,0.166666666666667,0,0,0.5,0,0.5
"25017311200",2017,25,0,1,15,7,2,19,0,1,10,6,2,6,0,0,5,1,0,0,0.04,0.6,0.28,0.08,0.76,0,0.0526315789473684,0.526315789473684,0.315789473684211,0.105263157894737,0.24,0,0,0.833333333333333,0.166666666666667,0
"25017311300",2017,31,1,0,11,13,6,27,1,0,8,12,6,4,0,0,3,1,0,0.032258064516129,0,0.354838709677419,0.419354838709677,0.193548387096774,0.870967741935484,0.037037037037037,0,0.296296296296296,0.444444444444444,0.222222222222222,0.129032258064516,0,0,0.75,0.25,0
"25017311400",2017,55,0,1,19,21,14,46,0,0,18,17,11,9,0,1,1,4,3,0,0.0181818181818182,0.345454545454545,0.381818181818182,0.254545454545455,0.836363636363636,0,0,0.391304347826087,0.369565217391304,0.239130434782609,0.163636363636364,0,0.111111111111111,0.111111111111111,0.444444444444444,0.333333333333333
"25017311500",2017,47,0,1,22,20,4,39,0,1,19,17,2,8,0,0,3,3,2,0,0.0212765957446809,0.468085106382979,0.425531914893617,0.0851063829787234,0.829787234042553,0,0.0256410256410256,0.487179487179487,0.435897435897436,0.0512820512820513,0.170212765957447,0,0,0.375,0.375,0.25
"25017311600",2017,60,0,0,31,22,7,57,0,0,29,21,7,3,0,0,2,1,0,0,0,0.516666666666667,0.366666666666667,0.116666666666667,0.95,0,0,0.508771929824561,0.368421052631579,0.12280701754386,0.05,0,0,0.666666666666667,0.333333333333333,0
"25017311700",2017,42,0,3,28,9,2,35,0,2,23,9,1,7,0,1,5,0,1,0,0.0714285714285714,0.666666666666667,0.214285714285714,0.0476190476190476,0.833333333333333,0,0.0571428571428571,0.657142857142857,0.257142857142857,0.0285714285714286,0.166666666666667,0,0.142857142857143,0.714285714285714,0,0.142857142857143
"25017311800",2017,31,0,0,17,10,4,24,0,0,14,8,2,7,0,0,3,2,2,0,0,0.548387096774194,0.32258064516129,0.129032258064516,0.774193548387097,0,0,0.583333333333333,0.333333333333333,0.0833333333333333,0.225806451612903,0,0,0.428571428571429,0.285714285714286,0.285714285714286
"25017311900",2017,20,0,1,12,5,2,12,0,0,8,3,1,8,0,1,4,2,1,0,0.05,0.6,0.25,0.1,0.6,0,0,0.666666666666667,0.25,0.0833333333333333,0.4,0,0.125,0.5,0.25,0.125
"25017312000",2017,35,0,5,20,5,5,28,0,2,19,3,4,7,0,3,1,2,1,0,0.142857142857143,0.571428571428571,0.142857142857143,0.142857142857143,0.8,0,0.0714285714285714,0.678571428571429,0.107142857142857,0.142857142857143,0.2,0,0.428571428571429,0.142857142857143,0.285714285714286,0.142857142857143
"25017312100",2017,37,0,1,14,17,5,33,0,1,12,16,4,4,0,0,2,1,1,0,0.027027027027027,0.378378378378378,0.459459459459459,0.135135135135135,0.891891891891892,0,0.0303030303030303,0.363636363636364,0.484848484848485,0.121212121212121,0.108108108108108,0,0,0.5,0.25,0.25
"25017312200",2017,53,0,1,35,14,3,48,0,1,32,12,3,5,0,0,3,2,0,0,0.0188679245283019,0.660377358490566,0.264150943396226,0.0566037735849057,0.905660377358491,0,0.0208333333333333,0.666666666666667,0.25,0.0625,0.0943396226415094,0,0,0.6,0.4,0
"25017312300",2017,79,0,1,40,26,12,73,0,1,37,23,12,6,0,0,3,3,0,0,0.0126582278481013,0.506329113924051,0.329113924050633,0.151898734177215,0.924050632911392,0,0.0136986301369863,0.506849315068493,0.315068493150685,0.164383561643836,0.0759493670886076,0,0,0.5,0.5,0
"25017312400",2017,21,0,0,13,6,2,19,0,0,11,6,2,2,0,0,2,0,0,0,0,0.619047619047619,0.285714285714286,0.0952380952380952,0.904761904761905,0,0,0.578947368421053,0.315789473684211,0.105263157894737,0.0952380952380952,0,0,1,0,0
"25017312501",2017,69,0,1,16,36,16,64,0,0,14,34,16,5,0,1,2,2,0,0,0.0144927536231884,0.231884057971014,0.521739130434783,0.231884057971014,0.927536231884058,0,0,0.21875,0.53125,0.25,0.072463768115942,0,0.2,0.4,0.4,0
"25017312502",2017,65,0,2,20,23,20,55,0,2,16,22,15,10,0,0,4,1,5,0,0.0307692307692308,0.307692307692308,0.353846153846154,0.307692307692308,0.846153846153846,0,0.0363636363636364,0.290909090909091,0.4,0.272727272727273,0.153846153846154,0,0,0.4,0.1,0.5
"25017313101",2017,92,0,4,28,31,29,86,0,3,26,29,28,6,0,1,2,2,1,0,0.0434782608695652,0.304347826086957,0.33695652173913,0.315217391304348,0.934782608695652,0,0.0348837209302326,0.302325581395349,0.337209302325581,0.325581395348837,0.0652173913043478,0,0.166666666666667,0.333333333333333,0.333333333333333,0.166666666666667
"25017313102",2017,82,0,1,31,31,19,70,0,0,24,28,18,12,0,1,7,3,1,0,0.0121951219512195,0.378048780487805,0.378048780487805,0.231707317073171,0.853658536585366,0,0,0.342857142857143,0.4,0.257142857142857,0.146341463414634,0,0.0833333333333333,0.583333333333333,0.25,0.0833333333333333
"25017314101",2017,109,0,2,43,45,19,96,0,2,34,42,18,13,0,0,9,3,1,0,0.018348623853211,0.394495412844037,0.412844036697248,0.174311926605505,0.880733944954128,0,0.0208333333333333,0.354166666666667,0.4375,0.1875,0.119266055045872,0,0,0.692307692307692,0.230769230769231,0.0769230769230769
"25017314102",2017,141,0,5,75,42,19,127,0,4,64,40,19,14,0,1,11,2,0,0,0.0354609929078014,0.531914893617021,0.297872340425532,0.134751773049645,0.900709219858156,0,0.031496062992126,0.503937007874016,0.31496062992126,0.149606299212598,0.099290780141844,0,0.0714285714285714,0.785714285714286,0.142857142857143,0
"25017314200",2017,81,0,2,38,26,15,76,0,2,34,26,14,5,0,0,4,0,1,0,0.0246913580246914,0.469135802469136,0.320987654320988,0.185185185185185,0.938271604938272,0,0.0263157894736842,0.447368421052632,0.342105263157895,0.184210526315789,0.0617283950617284,0,0,0.8,0,0.2
"25017314301",2017,180,0,6,61,70,43,158,0,3,51,64,40,22,0,3,10,6,3,0,0.0333333333333333,0.338888888888889,0.388888888888889,0.238888888888889,0.877777777777778,0,0.0189873417721519,0.322784810126582,0.40506329113924,0.253164556962025,0.122222222222222,0,0.136363636363636,0.454545454545455,0.272727272727273,0.136363636363636
"25017314302",2017,47,0,0,6,25,16,43,0,0,6,24,13,4,0,0,0,1,3,0,0,0.127659574468085,0.531914893617021,0.340425531914894,0.914893617021277,0,0,0.13953488372093,0.558139534883721,0.302325581395349,0.0851063829787234,0,0,0,0.25,0.75
"25017315100",2017,91,1,0,17,42,31,84,0,0,15,40,29,7,1,0,2,2,2,0.010989010989011,0,0.186813186813187,0.461538461538462,0.340659340659341,0.923076923076923,0,0,0.178571428571429,0.476190476190476,0.345238095238095,0.0769230769230769,0.142857142857143,0,0.285714285714286,0.285714285714286,0.285714285714286
"25017315200",2017,109,0,3,23,52,31,102,0,0,20,51,31,7,0,3,3,1,0,0,0.0275229357798165,0.211009174311927,0.477064220183486,0.284403669724771,0.935779816513762,0,0,0.196078431372549,0.5,0.303921568627451,0.0642201834862385,0,0.428571428571429,0.428571428571429,0.142857142857143,0
"25017315401",2017,82,0,1,28,36,17,77,0,1,26,35,15,5,0,0,2,1,2,0,0.0121951219512195,0.341463414634146,0.439024390243902,0.207317073170732,0.939024390243902,0,0.012987012987013,0.337662337662338,0.454545454545455,0.194805194805195,0.0609756097560976,0,0,0.4,0.2,0.4
"25017315402",2017,48,0,0,4,23,21,48,0,0,4,23,21,0,0,0,0,0,0,0,0,0.0833333333333333,0.479166666666667,0.4375,1,0,0,0.0833333333333333,0.479166666666667,0.4375,0,0,0,0,0,0
"25017315403",2017,21,0,0,6,11,4,20,0,0,5,11,4,1,0,0,1,0,0,0,0,0.285714285714286,0.523809523809524,0.19047619047619,0.952380952380952,0,0,0.25,0.55,0.2,0.0476190476190476,0,0,1,0,0
"25017315500",2017,88,0,0,21,38,29,82,0,0,19,36,27,6,0,0,2,2,2,0,0,0.238636363636364,0.431818181818182,0.329545454545455,0.931818181818182,0,0,0.231707317073171,0.439024390243902,0.329268292682927,0.0681818181818182,0,0,0.333333333333333,0.333333333333333,0.333333333333333
"25017316101",2017,52,0,0,8,35,9,51,0,0,8,34,9,1,0,0,0,1,0,0,0,0.153846153846154,0.673076923076923,0.173076923076923,0.980769230769231,0,0,0.156862745098039,0.666666666666667,0.176470588235294,0.0192307692307692,0,0,0,1,0
"25017316102",2017,73,0,0,9,38,26,68,0,0,9,35,24,5,0,0,0,3,2,0,0,0.123287671232877,0.520547945205479,0.356164383561644,0.931506849315068,0,0,0.132352941176471,0.514705882352941,0.352941176470588,0.0684931506849315,0,0,0,0.6,0.4
"25017316201",2017,45,0,0,11,17,17,45,0,0,11,17,17,0,0,0,0,0,0,0,0,0.244444444444444,0.377777777777778,0.377777777777778,1,0,0,0.244444444444444,0.377777777777778,0.377777777777778,0,0,0,0,0,0
"25017316202",2017,57,0,0,14,30,13,55,0,0,13,29,13,2,0,0,1,1,0,0,0,0.245614035087719,0.526315789473684,0.228070175438596,0.964912280701754,0,0,0.236363636363636,0.527272727272727,0.236363636363636,0.0350877192982456,0,0,0.5,0.5,0
"25017316300",2017,90,0,1,21,40,28,87,0,1,19,39,28,3,0,0,2,1,0,0,0.0111111111111111,0.233333333333333,0.444444444444444,0.311111111111111,0.966666666666667,0,0.0114942528735632,0.218390804597701,0.448275862068966,0.32183908045977,0.0333333333333333,0,0,0.666666666666667,0.333333333333333,0
"25017316400",2017,79,0,2,9,30,38,75,0,2,7,29,37,4,0,0,2,1,1,0,0.0253164556962025,0.113924050632911,0.379746835443038,0.481012658227848,0.949367088607595,0,0.0266666666666667,0.0933333333333333,0.386666666666667,0.493333333333333,0.0506329113924051,0,0,0.5,0.25,0.25
"25017316500",2017,76,0,2,24,28,22,66,0,0,23,23,20,10,0,2,1,5,2,0,0.0263157894736842,0.315789473684211,0.368421052631579,0.289473684210526,0.868421052631579,0,0,0.348484848484849,0.348484848484849,0.303030303030303,0.131578947368421,0,0.2,0.1,0.5,0.2
"25017317101",2017,126,0,6,28,36,56,102,0,0,19,33,50,24,0,6,9,3,6,0,0.0476190476190476,0.222222222222222,0.285714285714286,0.444444444444444,0.80952380952381,0,0,0.186274509803922,0.323529411764706,0.490196078431373,0.19047619047619,0,0.25,0.375,0.125,0.25
"25017317102",2017,60,0,0,10,23,27,59,0,0,10,23,26,1,0,0,0,0,1,0,0,0.166666666666667,0.383333333333333,0.45,0.983333333333333,0,0,0.169491525423729,0.389830508474576,0.440677966101695,0.0166666666666667,0,0,0,0,1
"25017317103",2017,67,0,0,5,33,29,62,0,0,4,29,29,5,0,0,1,4,0,0,0,0.0746268656716418,0.492537313432836,0.432835820895522,0.925373134328358,0,0,0.0645161290322581,0.467741935483871,0.467741935483871,0.0746268656716418,0,0,0.2,0.8,0
"25017317201",2017,34,0,0,3,12,19,33,0,0,3,12,18,1,0,0,0,0,1,0,0,0.0882352941176471,0.352941176470588,0.558823529411765,0.970588235294118,0,0,0.0909090909090909,0.363636363636364,0.545454545454545,0.0294117647058824,0,0,0,0,1
"25017317202",2017,47,0,0,1,16,30,45,0,0,0,16,29,2,0,0,1,0,1,0,0,0.0212765957446809,0.340425531914894,0.638297872340426,0.957446808510638,0,0,0,0.355555555555556,0.644444444444444,0.0425531914893617,0,0,0.5,0,0.5
"25017317203",2017,58,0,2,6,31,19,55,0,1,5,31,18,3,0,1,1,0,1,0,0.0344827586206897,0.103448275862069,0.53448275862069,0.327586206896552,0.948275862068966,0,0.0181818181818182,0.0909090909090909,0.563636363636364,0.327272727272727,0.0517241379310345,0,0.333333333333333,0.333333333333333,0,0.333333333333333
"25017317301",2017,41,0,0,12,16,13,39,0,0,12,15,12,2,0,0,0,1,1,0,0,0.292682926829268,0.390243902439024,0.317073170731707,0.951219512195122,0,0,0.307692307692308,0.384615384615385,0.307692307692308,0.0487804878048781,0,0,0,0.5,0.5
"25017317302",2017,137,0,4,38,56,39,128,0,4,34,53,37,9,0,0,4,3,2,0,0.0291970802919708,0.277372262773723,0.408759124087591,0.284671532846715,0.934306569343066,0,0.03125,0.265625,0.4140625,0.2890625,0.0656934306569343,0,0,0.444444444444444,0.333333333333333,0.222222222222222
"25017318100",2017,103,0,0,8,37,58,96,0,0,8,35,53,7,0,0,0,2,5,0,0,0.0776699029126214,0.359223300970874,0.563106796116505,0.932038834951456,0,0,0.0833333333333333,0.364583333333333,0.552083333333333,0.0679611650485437,0,0,0,0.285714285714286,0.714285714285714
"25017318200",2017,76,0,0,10,32,34,68,0,0,9,29,30,8,0,0,1,3,4,0,0,0.131578947368421,0.421052631578947,0.447368421052632,0.894736842105263,0,0,0.132352941176471,0.426470588235294,0.441176470588235,0.105263157894737,0,0,0.125,0.375,0.5
"25017318300",2017,119,0,0,7,28,84,112,0,0,6,27,79,7,0,0,1,1,5,0,0,0.0588235294117647,0.235294117647059,0.705882352941177,0.941176470588235,0,0,0.0535714285714286,0.241071428571429,0.705357142857143,0.0588235294117647,0,0,0.142857142857143,0.142857142857143,0.714285714285714
"25017318400",2017,51,0,1,2,9,39,48,0,1,1,9,37,3,0,0,1,0,2,0,0.0196078431372549,0.0392156862745098,0.176470588235294,0.764705882352941,0.941176470588235,0,0.0208333333333333,0.0208333333333333,0.1875,0.770833333333333,0.0588235294117647,0,0,0.333333333333333,0,0.666666666666667
"25017320102",2017,91,0,0,10,21,60,83,0,0,9,19,55,8,0,0,1,2,5,0,0,0.10989010989011,0.230769230769231,0.659340659340659,0.912087912087912,0,0,0.108433734939759,0.228915662650602,0.662650602409639,0.0879120879120879,0,0,0.125,0.25,0.625
"25017320103",2017,72,0,0,6,16,50,71,0,0,6,16,49,1,0,0,0,0,1,0,0,0.0833333333333333,0.222222222222222,0.694444444444444,0.986111111111111,0,0,0.0845070422535211,0.225352112676056,0.690140845070423,0.0138888888888889,0,0,0,0,1
"25017320104",2017,188,0,1,8,48,131,181,0,1,8,48,124,7,0,0,0,0,7,0,0.00531914893617021,0.0425531914893617,0.25531914893617,0.696808510638298,0.962765957446808,0,0.00552486187845304,0.0441988950276243,0.265193370165746,0.685082872928177,0.0372340425531915,0,0,0,0,1
"25017321100",2017,88,1,2,12,35,38,77,0,0,9,33,35,11,1,2,3,2,3,0.0113636363636364,0.0227272727272727,0.136363636363636,0.397727272727273,0.431818181818182,0.875,0,0,0.116883116883117,0.428571428571429,0.454545454545455,0.125,0.0909090909090909,0.181818181818182,0.272727272727273,0.181818181818182,0.272727272727273
"25017321200",2017,86,2,1,33,30,20,76,0,1,30,27,18,10,2,0,3,3,2,0.0232558139534884,0.0116279069767442,0.383720930232558,0.348837209302326,0.232558139534884,0.883720930232558,0,0.0131578947368421,0.394736842105263,0.355263157894737,0.236842105263158,0.116279069767442,0.2,0,0.3,0.3,0.2
"25017321300",2017,96,0,0,27,45,24,88,0,0,24,42,22,8,0,0,3,3,2,0,0,0.28125,0.46875,0.25,0.916666666666667,0,0,0.272727272727273,0.477272727272727,0.25,0.0833333333333333,0,0,0.375,0.375,0.25
"25017321400",2017,45,0,0,9,21,15,43,0,0,9,20,14,2,0,0,0,1,1,0,0,0.2,0.466666666666667,0.333333333333333,0.955555555555556,0,0,0.209302325581395,0.465116279069767,0.325581395348837,0.0444444444444444,0,0,0,0.5,0.5
"25017321500",2017,134,0,1,54,40,39,118,0,0,45,37,36,16,0,1,9,3,3,0,0.00746268656716418,0.402985074626866,0.298507462686567,0.291044776119403,0.880597014925373,0,0,0.38135593220339,0.313559322033898,0.305084745762712,0.119402985074627,0,0.0625,0.5625,0.1875,0.1875
"25017321600",2017,107,0,2,29,44,32,101,0,1,27,43,30,6,0,1,2,1,2,0,0.0186915887850467,0.271028037383178,0.411214953271028,0.299065420560748,0.94392523364486,0,0.0099009900990099,0.267326732673267,0.425742574257426,0.297029702970297,0.0560747663551402,0,0.166666666666667,0.333333333333333,0.166666666666667,0.333333333333333
"25017322100",2017,67,0,0,17,25,25,63,0,0,15,25,23,4,0,0,2,0,2,0,0,0.253731343283582,0.373134328358209,0.373134328358209,0.940298507462687,0,0,0.238095238095238,0.396825396825397,0.365079365079365,0.0597014925373134,0,0,0.5,0,0.5
"25017322200",2017,76,0,0,17,29,30,72,0,0,16,27,29,4,0,0,1,2,1,0,0,0.223684210526316,0.381578947368421,0.394736842105263,0.947368421052632,0,0,0.222222222222222,0.375,0.402777777777778,0.0526315789473684,0,0,0.25,0.5,0.25
"25017322300",2017,79,0,0,25,36,18,76,0,0,24,34,18,3,0,0,1,2,0,0,0,0.316455696202532,0.455696202531646,0.227848101265823,0.962025316455696,0,0,0.315789473684211,0.447368421052632,0.236842105263158,0.0379746835443038,0,0,0.333333333333333,0.666666666666667,0
"25017322400",2017,55,0,1,7,26,21,52,0,1,7,24,20,3,0,0,0,2,1,0,0.0181818181818182,0.127272727272727,0.472727272727273,0.381818181818182,0.945454545454545,0,0.0192307692307692,0.134615384615385,0.461538461538462,0.384615384615385,0.0545454545454545,0,0,0,0.666666666666667,0.333333333333333
"25017323100",2017,119,0,1,6,33,79,110,0,1,5,30,74,9,0,0,1,3,5,0,0.00840336134453781,0.0504201680672269,0.277310924369748,0.663865546218487,0.92436974789916,0,0.00909090909090909,0.0454545454545455,0.272727272727273,0.672727272727273,0.0756302521008403,0,0,0.111111111111111,0.333333333333333,0.555555555555556
"25017324101",2017,101,0,0,13,26,62,97,0,0,13,25,59,4,0,0,0,1,3,0,0,0.128712871287129,0.257425742574257,0.613861386138614,0.96039603960396,0,0,0.134020618556701,0.257731958762887,0.608247422680412,0.0396039603960396,0,0,0,0.25,0.75
"25017324102",2017,61,0,0,7,16,38,55,0,0,6,14,35,6,0,0,1,2,3,0,0,0.114754098360656,0.262295081967213,0.622950819672131,0.901639344262295,0,0,0.109090909090909,0.254545454545455,0.636363636363636,0.0983606557377049,0,0,0.166666666666667,0.333333333333333,0.5
"25017325100",2017,108,0,5,25,43,35,99,0,1,25,41,32,9,0,4,0,2,3,0,0.0462962962962963,0.231481481481481,0.398148148148148,0.324074074074074,0.916666666666667,0,0.0101010101010101,0.252525252525253,0.414141414141414,0.323232323232323,0.0833333333333333,0,0.444444444444444,0,0.222222222222222,0.333333333333333
"25017326101",2017,88,1,0,14,24,49,82,0,0,13,22,47,6,1,0,1,2,2,0.0113636363636364,0,0.159090909090909,0.272727272727273,0.556818181818182,0.931818181818182,0,0,0.158536585365854,0.268292682926829,0.573170731707317,0.0681818181818182,0.166666666666667,0,0.166666666666667,0.333333333333333,0.333333333333333
"25017326102",2017,108,0,0,19,34,55,100,0,0,18,30,52,8,0,0,1,4,3,0,0,0.175925925925926,0.314814814814815,0.509259259259259,0.925925925925926,0,0,0.18,0.3,0.52,0.0740740740740741,0,0,0.125,0.5,0.375
"25017327101",2017,61,0,2,15,32,12,53,0,1,12,28,12,8,0,1,3,4,0,0,0.0327868852459016,0.245901639344262,0.524590163934426,0.19672131147541,0.868852459016393,0,0.0188679245283019,0.226415094339623,0.528301886792453,0.226415094339623,0.131147540983607,0,0.125,0.375,0.5,0
"25017327102",2017,58,0,1,22,16,19,53,0,1,18,15,19,5,0,0,4,1,0,0,0.0172413793103448,0.379310344827586,0.275862068965517,0.327586206896552,0.913793103448276,0,0.0188679245283019,0.339622641509434,0.283018867924528,0.358490566037736,0.0862068965517241,0,0,0.8,0.2,0
"25017327103",2017,64,0,0,14,26,24,58,0,0,12,24,22,6,0,0,2,2,2,0,0,0.21875,0.40625,0.375,0.90625,0,0,0.206896551724138,0.413793103448276,0.379310344827586,0.09375,0,0,0.333333333333333,0.333333333333333,0.333333333333333
"25017328100",2017,52,0,0,6,13,33,49,0,0,5,13,31,3,0,0,1,0,2,0,0,0.115384615384615,0.25,0.634615384615385,0.942307692307692,0,0,0.102040816326531,0.26530612244898,0.63265306122449,0.0576923076923077,0,0,0.333333333333333,0,0.666666666666667
"25017330100",2017,141,0,1,9,39,92,137,0,0,8,38,91,4,0,1,1,1,1,0,0.00709219858156028,0.0638297872340425,0.276595744680851,0.652482269503546,0.971631205673759,0,0,0.0583941605839416,0.277372262773723,0.664233576642336,0.0283687943262411,0,0.25,0.25,0.25,0.25
"25017330200",2017,105,0,0,25,37,43,100,0,0,25,33,42,5,0,0,0,4,1,0,0,0.238095238095238,0.352380952380952,0.40952380952381,0.952380952380952,0,0,0.25,0.33,0.42,0.0476190476190476,0,0,0,0.8,0.2
"25017331101",2017,35,0,1,2,14,18,34,0,1,2,14,17,1,0,0,0,0,1,0,0.0285714285714286,0.0571428571428571,0.4,0.514285714285714,0.971428571428571,0,0.0294117647058824,0.0588235294117647,0.411764705882353,0.5,0.0285714285714286,0,0,0,0,1
"25017331102",2017,84,0,0,11,36,37,78,0,0,10,33,35,6,0,0,1,3,2,0,0,0.130952380952381,0.428571428571429,0.44047619047619,0.928571428571429,0,0,0.128205128205128,0.423076923076923,0.448717948717949,0.0714285714285714,0,0,0.166666666666667,0.5,0.333333333333333
"25017331200",2017,79,0,0,7,36,36,78,0,0,7,36,35,1,0,0,0,0,1,0,0,0.0886075949367089,0.455696202531646,0.455696202531646,0.987341772151899,0,0,0.0897435897435897,0.461538461538462,0.448717948717949,0.0126582278481013,0,0,0,0,1
"25017331300",2017,93,0,0,9,33,51,88,0,0,8,32,48,5,0,0,1,1,3,0,0,0.0967741935483871,0.354838709677419,0.548387096774194,0.946236559139785,0,0,0.0909090909090909,0.363636363636364,0.545454545454545,0.0537634408602151,0,0,0.2,0.2,0.6
"25017332100",2017,69,0,0,1,20,48,66,0,0,1,18,47,3,0,0,0,2,1,0,0,0.0144927536231884,0.289855072463768,0.695652173913043,0.956521739130435,0,0,0.0151515151515152,0.272727272727273,0.712121212121212,0.0434782608695652,0,0,0,0.666666666666667,0.333333333333333
"25017332200",2017,73,0,0,9,32,32,66,0,0,7,29,30,7,0,0,2,3,2,0,0,0.123287671232877,0.438356164383562,0.438356164383562,0.904109589041096,0,0,0.106060606060606,0.439393939393939,0.454545454545455,0.0958904109589041,0,0,0.285714285714286,0.428571428571429,0.285714285714286
"25017332300",2017,72,0,0,5,27,40,70,0,0,4,26,40,2,0,0,1,1,0,0,0,0.0694444444444444,0.375,0.555555555555556,0.972222222222222,0,0,0.0571428571428571,0.371428571428571,0.571428571428571,0.0277777777777778,0,0,0.5,0.5,0
"25017332400",2017,32,0,0,2,7,23,31,0,0,2,7,22,1,0,0,0,0,1,0,0,0.0625,0.21875,0.71875,0.96875,0,0,0.0645161290322581,0.225806451612903,0.709677419354839,0.03125,0,0,0,0,1
"25017333100",2017,72,0,0,6,32,34,71,0,0,6,32,33,1,0,0,0,0,1,0,0,0.0833333333333333,0.444444444444444,0.472222222222222,0.986111111111111,0,0,0.0845070422535211,0.450704225352113,0.464788732394366,0.0138888888888889,0,0,0,0,1
"25017333200",2017,67,0,1,13,22,31,64,0,1,12,20,31,3,0,0,1,2,0,0,0.0149253731343284,0.194029850746269,0.328358208955224,0.462686567164179,0.955223880597015,0,0.015625,0.1875,0.3125,0.484375,0.0447761194029851,0,0,0.333333333333333,0.666666666666667,0
"25017333300",2017,57,0,1,18,25,13,51,0,1,12,25,13,6,0,0,6,0,0,0,0.0175438596491228,0.315789473684211,0.43859649122807,0.228070175438596,0.894736842105263,0,0.0196078431372549,0.235294117647059,0.490196078431373,0.254901960784314,0.105263157894737,0,0,1,0,0
"25017333400",2017,80,0,1,16,25,38,76,0,1,15,25,35,4,0,0,1,0,3,0,0.0125,0.2,0.3125,0.475,0.95,0,0.0131578947368421,0.197368421052632,0.328947368421053,0.460526315789474,0.05,0,0,0.25,0,0.75
"25017333501",2017,53,0,0,13,23,17,48,0,0,10,22,16,5,0,0,3,1,1,0,0,0.245283018867925,0.433962264150943,0.320754716981132,0.905660377358491,0,0,0.208333333333333,0.458333333333333,0.333333333333333,0.0943396226415094,0,0,0.6,0.2,0.2
"25017333502",2017,37,0,0,8,10,19,36,0,0,8,10,18,1,0,0,0,0,1,0,0,0.216216216216216,0.27027027027027,0.513513513513513,0.972972972972973,0,0,0.222222222222222,0.277777777777778,0.5,0.027027027027027,0,0,0,0,1
"25017333600",2017,87,0,0,15,35,37,77,0,0,11,33,33,10,0,0,4,2,4,0,0,0.172413793103448,0.402298850574713,0.425287356321839,0.885057471264368,0,0,0.142857142857143,0.428571428571429,0.428571428571429,0.114942528735632,0,0,0.4,0.2,0.4
"25017334100",2017,138,0,0,9,35,94,129,0,0,8,32,89,9,0,0,1,3,5,0,0,0.0652173913043478,0.253623188405797,0.681159420289855,0.934782608695652,0,0,0.062015503875969,0.248062015503876,0.689922480620155,0.0652173913043478,0,0,0.111111111111111,0.333333333333333,0.555555555555556
"25017334200",2017,59,0,0,3,19,37,57,0,0,3,17,37,2,0,0,0,2,0,0,0,0.0508474576271186,0.322033898305085,0.627118644067797,0.966101694915254,0,0,0.0526315789473684,0.298245614035088,0.649122807017544,0.0338983050847458,0,0,0,1,0
"25017334300",2017,93,0,0,3,19,71,93,0,0,3,19,71,0,0,0,0,0,0,0,0,0.032258064516129,0.204301075268817,0.763440860215054,1,0,0,0.032258064516129,0.204301075268817,0.763440860215054,0,0,0,0,0,0
"25017334400",2017,111,0,1,18,36,56,106,0,1,18,34,53,5,0,0,0,2,3,0,0.00900900900900901,0.162162162162162,0.324324324324324,0.504504504504504,0.954954954954955,0,0.00943396226415094,0.169811320754717,0.320754716981132,0.5,0.045045045045045,0,0,0,0.4,0.6
"25017335100",2017,85,0,0,12,32,41,78,0,0,12,30,36,7,0,0,0,2,5,0,0,0.141176470588235,0.376470588235294,0.482352941176471,0.917647058823529,0,0,0.153846153846154,0.384615384615385,0.461538461538462,0.0823529411764706,0,0,0,0.285714285714286,0.714285714285714
"25017335200",2017,86,0,0,7,28,51,84,0,0,7,28,49,2,0,0,0,0,2,0,0,0.0813953488372093,0.325581395348837,0.593023255813954,0.976744186046512,0,0,0.0833333333333333,0.333333333333333,0.583333333333333,0.0232558139534884,0,0,0,0,1
"25017335301",2017,57,0,1,6,25,25,55,0,1,6,23,25,2,0,0,0,2,0,0,0.0175438596491228,0.105263157894737,0.43859649122807,0.43859649122807,0.964912280701754,0,0.0181818181818182,0.109090909090909,0.418181818181818,0.454545454545455,0.0350877192982456,0,0,0,1,0
"25017335302",2017,62,0,0,6,27,29,58,0,0,5,26,27,4,0,0,1,1,2,0,0,0.0967741935483871,0.435483870967742,0.467741935483871,0.935483870967742,0,0,0.0862068965517241,0.448275862068966,0.46551724137931,0.0645161290322581,0,0,0.25,0.25,0.5
"25017335400",2017,70,0,0,11,19,40,66,0,0,9,17,40,4,0,0,2,2,0,0,0,0.157142857142857,0.271428571428571,0.571428571428571,0.942857142857143,0,0,0.136363636363636,0.257575757575758,0.606060606060606,0.0571428571428571,0,0,0.5,0.5,0
"25017336100",2017,84,0,1,12,27,44,79,0,1,11,25,42,5,0,0,1,2,2,0,0.0119047619047619,0.142857142857143,0.321428571428571,0.523809523809524,0.94047619047619,0,0.0126582278481013,0.139240506329114,0.316455696202532,0.531645569620253,0.0595238095238095,0,0,0.2,0.4,0.4
"25017336200",2017,89,0,0,5,16,68,88,0,0,5,16,67,1,0,0,0,0,1,0,0,0.0561797752808989,0.179775280898876,0.764044943820225,0.98876404494382,0,0,0.0568181818181818,0.181818181818182,0.761363636363636,0.0112359550561798,0,0,0,0,1
"25017336300",2017,85,0,0,4,22,59,79,0,0,4,21,54,6,0,0,0,1,5,0,0,0.0470588235294118,0.258823529411765,0.694117647058824,0.929411764705882,0,0,0.0506329113924051,0.265822784810127,0.683544303797468,0.0705882352941176,0,0,0,0.166666666666667,0.833333333333333
"25017336401",2017,64,0,0,13,28,23,61,0,0,12,26,23,3,0,0,1,2,0,0,0,0.203125,0.4375,0.359375,0.953125,0,0,0.19672131147541,0.426229508196721,0.377049180327869,0.046875,0,0,0.333333333333333,0.666666666666667,0
"25017336402",2017,54,0,1,4,16,33,51,0,1,4,15,31,3,0,0,0,1,2,0,0.0185185185185185,0.0740740740740741,0.296296296296296,0.611111111111111,0.944444444444444,0,0.0196078431372549,0.0784313725490196,0.294117647058824,0.607843137254902,0.0555555555555556,0,0,0,0.333333333333333,0.666666666666667
"25017337101",2017,39,0,0,7,12,20,37,0,0,7,11,19,2,0,0,0,1,1,0,0,0.179487179487179,0.307692307692308,0.512820512820513,0.948717948717949,0,0,0.189189189189189,0.297297297297297,0.513513513513513,0.0512820512820513,0,0,0,0.5,0.5
"25017337102",2017,68,0,1,11,17,39,67,0,1,10,17,39,1,0,0,1,0,0,0,0.0147058823529412,0.161764705882353,0.25,0.573529411764706,0.985294117647059,0,0.0149253731343284,0.149253731343284,0.253731343283582,0.582089552238806,0.0147058823529412,0,0,1,0,0
"25017337201",2017,36,0,0,10,13,13,36,0,0,10,13,13,0,0,0,0,0,0,0,0,0.277777777777778,0.361111111111111,0.361111111111111,1,0,0,0.277777777777778,0.361111111111111,0.361111111111111,0,0,0,0,0,0
"25017337202",2017,65,0,0,13,29,23,61,0,0,13,26,22,4,0,0,0,3,1,0,0,0.2,0.446153846153846,0.353846153846154,0.938461538461538,0,0,0.213114754098361,0.426229508196721,0.360655737704918,0.0615384615384615,0,0,0,0.75,0.25
"25017337300",2017,97,0,0,14,46,37,92,0,0,12,43,37,5,0,0,2,3,0,0,0,0.144329896907216,0.474226804123711,0.381443298969072,0.948453608247423,0,0,0.130434782608696,0.467391304347826,0.402173913043478,0.0515463917525773,0,0,0.4,0.6,0
"25017338100",2017,47,0,0,2,6,39,46,0,0,2,6,38,1,0,0,0,0,1,0,0,0.0425531914893617,0.127659574468085,0.829787234042553,0.978723404255319,0,0,0.0434782608695652,0.130434782608696,0.826086956521739,0.0212765957446809,0,0,0,0,1
"25017338200",2017,71,0,1,4,17,49,69,0,1,3,17,48,2,0,0,1,0,1,0,0.0140845070422535,0.0563380281690141,0.23943661971831,0.690140845070423,0.971830985915493,0,0.0144927536231884,0.0434782608695652,0.246376811594203,0.695652173913043,0.028169014084507,0,0,0.5,0,0.5
"25017338300",2017,47,0,0,2,7,38,44,0,0,2,5,37,3,0,0,0,2,1,0,0,0.0425531914893617,0.148936170212766,0.808510638297872,0.936170212765957,0,0,0.0454545454545455,0.113636363636364,0.840909090909091,0.0638297872340425,0,0,0,0.666666666666667,0.333333333333333
"25017338400",2017,91,0,0,2,5,84,86,0,0,2,3,81,5,0,0,0,2,3,0,0,0.021978021978022,0.0549450549450549,0.923076923076923,0.945054945054945,0,0,0.0232558139534884,0.0348837209302326,0.941860465116279,0.0549450549450549,0,0,0,0.4,0.6
"25017338500",2017,103,0,0,1,9,93,100,0,0,1,9,90,3,0,0,0,0,3,0,0,0.00970873786407767,0.087378640776699,0.902912621359223,0.970873786407767,0,0,0.01,0.09,0.9,0.029126213592233,0,0,0,0,1
"25017339100",2017,97,0,0,9,28,60,93,0,0,8,26,59,4,0,0,1,2,1,0,0,0.0927835051546392,0.288659793814433,0.618556701030928,0.958762886597938,0,0,0.0860215053763441,0.279569892473118,0.634408602150538,0.0412371134020619,0,0,0.25,0.5,0.25
"25017339200",2017,75,0,1,3,20,51,73,0,1,3,19,50,2,0,0,0,1,1,0,0.0133333333333333,0.04,0.266666666666667,0.68,0.973333333333333,0,0.0136986301369863,0.0410958904109589,0.26027397260274,0.684931506849315,0.0266666666666667,0,0,0,0.5,0.5
"25017339300",2017,32,0,0,2,8,22,31,0,0,2,7,22,1,0,0,0,1,0,0,0,0.0625,0.25,0.6875,0.96875,0,0,0.0645161290322581,0.225806451612903,0.709677419354839,0.03125,0,0,0,1,0
"25017339400",2017,23,0,0,0,6,17,21,0,0,0,6,15,2,0,0,0,0,2,0,0,0,0.260869565217391,0.739130434782609,0.91304347826087,0,0,0,0.285714285714286,0.714285714285714,0.0869565217391304,0,0,0,0,1
"25017339500",2017,32,0,0,2,9,21,31,0,0,1,9,21,1,0,0,1,0,0,0,0,0.0625,0.28125,0.65625,0.96875,0,0,0.032258064516129,0.290322580645161,0.67741935483871,0.03125,0,0,1,0,0
"25017339600",2017,41,0,0,3,9,29,39,0,0,3,9,27,2,0,0,0,0,2,0,0,0.0731707317073171,0.219512195121951,0.707317073170732,0.951219512195122,0,0,0.0769230769230769,0.230769230769231,0.692307692307692,0.0487804878048781,0,0,0,0,1
"25017339700",2017,28,0,0,2,6,20,25,0,0,2,6,17,3,0,0,0,0,3,0,0,0.0714285714285714,0.214285714285714,0.714285714285714,0.892857142857143,0,0,0.08,0.24,0.68,0.107142857142857,0,0,0,0,1
"25017339801",2017,33,0,0,6,12,15,30,0,0,5,11,14,3,0,0,1,1,1,0,0,0.181818181818182,0.363636363636364,0.454545454545455,0.909090909090909,0,0,0.166666666666667,0.366666666666667,0.466666666666667,0.0909090909090909,0,0,0.333333333333333,0.333333333333333,0.333333333333333
"25017339802",2017,47,0,0,12,16,19,44,0,0,12,15,17,3,0,0,0,1,2,0,0,0.25531914893617,0.340425531914894,0.404255319148936,0.936170212765957,0,0,0.272727272727273,0.340909090909091,0.386363636363636,0.0638297872340425,0,0,0,0.333333333333333,0.666666666666667
"25017339900",2017,56,0,0,7,19,30,54,0,0,6,19,29,2,0,0,1,0,1,0,0,0.125,0.339285714285714,0.535714285714286,0.964285714285714,0,0,0.111111111111111,0.351851851851852,0.537037037037037,0.0357142857142857,0,0,0.5,0,0.5
"25017340000",2017,35,0,0,1,23,11,31,0,0,1,19,11,4,0,0,0,4,0,0,0,0.0285714285714286,0.657142857142857,0.314285714285714,0.885714285714286,0,0,0.032258064516129,0.612903225806452,0.354838709677419,0.114285714285714,0,0,0,1,0
"25017340100",2017,108,0,0,7,38,63,104,0,0,7,35,62,4,0,0,0,3,1,0,0,0.0648148148148148,0.351851851851852,0.583333333333333,0.962962962962963,0,0,0.0673076923076923,0.336538461538462,0.596153846153846,0.037037037037037,0,0,0,0.75,0.25
"25017341101",2017,56,0,1,10,22,23,51,0,0,7,21,23,5,0,1,3,1,0,0,0.0178571428571429,0.178571428571429,0.392857142857143,0.410714285714286,0.910714285714286,0,0,0.137254901960784,0.411764705882353,0.450980392156863,0.0892857142857143,0,0.2,0.6,0.2,0
"25017341102",2017,27,1,0,7,9,10,24,1,0,6,8,9,3,0,0,1,1,1,0.037037037037037,0,0.259259259259259,0.333333333333333,0.37037037037037,0.888888888888889,0.0416666666666667,0,0.25,0.333333333333333,0.375,0.111111111111111,0,0,0.333333333333333,0.333333333333333,0.333333333333333
"25017341200",2017,53,0,0,13,25,15,49,0,0,12,22,15,4,0,0,1,3,0,0,0,0.245283018867925,0.471698113207547,0.283018867924528,0.924528301886792,0,0,0.244897959183673,0.448979591836735,0.306122448979592,0.0754716981132075,0,0,0.25,0.75,0
"25017341300",2017,11,0,0,6,2,3,10,0,0,5,2,3,1,0,0,1,0,0,0,0,0.545454545454545,0.181818181818182,0.272727272727273,0.909090909090909,0,0,0.5,0.2,0.3,0.0909090909090909,0,0,1,0,0
"25017341400",2017,62,1,0,13,32,16,59,1,0,11,31,16,3,0,0,2,1,0,0.0161290322580645,0,0.209677419354839,0.516129032258065,0.258064516129032,0.951612903225806,0.0169491525423729,0,0.186440677966102,0.525423728813559,0.271186440677966,0.0483870967741935,0,0,0.666666666666667,0.333333333333333,0
"25017341500",2017,54,0,1,14,23,16,49,0,0,14,20,15,5,0,1,0,3,1,0,0.0185185185185185,0.259259259259259,0.425925925925926,0.296296296296296,0.907407407407407,0,0,0.285714285714286,0.408163265306122,0.306122448979592,0.0925925925925926,0,0.2,0,0.6,0.2
"25017341600",2017,55,0,2,17,14,22,50,0,2,15,13,20,5,0,0,2,1,2,0,0.0363636363636364,0.309090909090909,0.254545454545455,0.4,0.909090909090909,0,0.04,0.3,0.26,0.4,0.0909090909090909,0,0,0.4,0.2,0.4
"25017341700",2017,74,0,1,18,35,20,69,0,1,15,33,20,5,0,0,3,2,0,0,0.0135135135135135,0.243243243243243,0.472972972972973,0.27027027027027,0.932432432432432,0,0.0144927536231884,0.217391304347826,0.478260869565217,0.289855072463768,0.0675675675675676,0,0,0.6,0.4,0
"25017341800",2017,61,0,1,15,34,11,57,0,1,14,32,10,4,0,0,1,2,1,0,0.0163934426229508,0.245901639344262,0.557377049180328,0.180327868852459,0.934426229508197,0,0.0175438596491228,0.245614035087719,0.56140350877193,0.175438596491228,0.0655737704918033,0,0,0.25,0.5,0.25
"25017341901",2017,20,0,0,9,8,3,19,0,0,8,8,3,1,0,0,1,0,0,0,0,0.45,0.4,0.15,0.95,0,0,0.421052631578947,0.421052631578947,0.157894736842105,0.05,0,0,1,0,0
"25017341902",2017,86,0,2,17,36,31,73,0,2,13,31,27,13,0,0,4,5,4,0,0.0232558139534884,0.197674418604651,0.418604651162791,0.36046511627907,0.848837209302326,0,0.0273972602739726,0.178082191780822,0.424657534246575,0.36986301369863,0.151162790697674,0,0,0.307692307692308,0.384615384615385,0.307692307692308
"25017342101",2017,40,1,0,14,17,8,37,0,0,13,16,8,3,1,0,1,1,0,0.025,0,0.35,0.425,0.2,0.925,0,0,0.351351351351351,0.432432432432432,0.216216216216216,0.075,0.333333333333333,0,0.333333333333333,0.333333333333333,0
"25017342102",2017,57,0,0,23,24,10,47,0,0,22,18,7,10,0,0,1,6,3,0,0,0.403508771929825,0.421052631578947,0.175438596491228,0.824561403508772,0,0,0.468085106382979,0.382978723404255,0.148936170212766,0.175438596491228,0,0,0.1,0.6,0.3
"25017342201",2017,53,0,0,16,22,15,48,0,0,13,20,15,5,0,0,3,2,0,0,0,0.30188679245283,0.415094339622642,0.283018867924528,0.905660377358491,0,0,0.270833333333333,0.416666666666667,0.3125,0.0943396226415094,0,0,0.6,0.4,0
"25017342202",2017,37,0,1,12,20,4,30,0,0,10,17,3,7,0,1,2,3,1,0,0.027027027027027,0.324324324324324,0.540540540540541,0.108108108108108,0.810810810810811,0,0,0.333333333333333,0.566666666666667,0.1,0.189189189189189,0,0.142857142857143,0.285714285714286,0.428571428571429,0.142857142857143
"25017342300",2017,64,1,1,10,33,19,57,0,0,8,31,18,7,1,1,2,2,1,0.015625,0.015625,0.15625,0.515625,0.296875,0.890625,0,0,0.140350877192982,0.543859649122807,0.315789473684211,0.109375,0.142857142857143,0.142857142857143,0.285714285714286,0.285714285714286,0.142857142857143
"25017342400",2017,43,0,1,11,19,12,36,0,0,9,16,11,7,0,1,2,3,1,0,0.0232558139534884,0.255813953488372,0.441860465116279,0.27906976744186,0.837209302325581,0,0,0.25,0.444444444444444,0.305555555555556,0.162790697674419,0,0.142857142857143,0.285714285714286,0.428571428571429,0.142857142857143
"25017342500",2017,40,0,0,12,15,13,37,0,0,9,15,13,3,0,0,3,0,0,0,0,0.3,0.375,0.325,0.925,0,0,0.243243243243243,0.405405405405405,0.351351351351351,0.075,0,0,1,0,0
"25017342600",2017,32,0,1,10,12,9,29,0,1,8,11,9,3,0,0,2,1,0,0,0.03125,0.3125,0.375,0.28125,0.90625,0,0.0344827586206897,0.275862068965517,0.379310344827586,0.310344827586207,0.09375,0,0,0.666666666666667,0.333333333333333,0
"25017350103",2017,13,0,0,1,2,10,7,0,0,0,0,7,6,0,0,1,2,3,0,0,0.0769230769230769,0.153846153846154,0.769230769230769,0.538461538461538,0,0,0,0,1,0.461538461538462,0,0,0.166666666666667,0.333333333333333,0.5
"25017350104",2017,42,0,0,3,12,27,38,0,0,3,11,24,4,0,0,0,1,3,0,0,0.0714285714285714,0.285714285714286,0.642857142857143,0.904761904761905,0,0,0.0789473684210526,0.289473684210526,0.631578947368421,0.0952380952380952,0,0,0,0.25,0.75
"25017350200",2017,68,0,0,7,16,45,65,0,0,7,13,45,3,0,0,0,3,0,0,0,0.102941176470588,0.235294117647059,0.661764705882353,0.955882352941177,0,0,0.107692307692308,0.2,0.692307692307692,0.0441176470588235,0,0,0,1,0
"25017350300",2017,39,0,0,5,9,25,39,0,0,5,9,25,0,0,0,0,0,0,0,0,0.128205128205128,0.230769230769231,0.641025641025641,1,0,0,0.128205128205128,0.230769230769231,0.641025641025641,0,0,0,0,0,0
"25017350400",2017,57,0,0,2,8,47,56,0,0,2,8,46,1,0,0,0,0,1,0,0,0.0350877192982456,0.140350877192982,0.824561403508772,0.982456140350877,0,0,0.0357142857142857,0.142857142857143,0.821428571428571,0.0175438596491228,0,0,0,0,1
"25017350500",2017,10,0,0,0,2,8,10,0,0,0,2,8,0,0,0,0,0,0,0,0,0,0.2,0.8,1,0,0,0,0.2,0.8,0,0,0,0,0,0
"25017350600",2017,16,0,0,0,3,13,15,0,0,0,3,12,1,0,0,0,0,1,0,0,0,0.1875,0.8125,0.9375,0,0,0,0.2,0.8,0.0625,0,0,0,0,1
"25017350700",2017,38,0,0,2,8,28,36,0,0,2,8,26,2,0,0,0,0,2,0,0,0.0526315789473684,0.210526315789474,0.736842105263158,0.947368421052632,0,0,0.0555555555555556,0.222222222222222,0.722222222222222,0.0526315789473684,0,0,0,0,1
"25017350800",2017,21,0,0,0,3,18,21,0,0,0,3,18,0,0,0,0,0,0,0,0,0,0.142857142857143,0.857142857142857,1,0,0,0,0.142857142857143,0.857142857142857,0,0,0,0,0,0
"25017350900",2017,27,0,0,0,3,24,25,0,0,0,3,22,2,0,0,0,0,2,0,0,0,0.111111111111111,0.888888888888889,0.925925925925926,0,0,0,0.12,0.88,0.0740740740740741,0,0,0,0,1
"25017351000",2017,77,0,0,2,12,63,74,0,0,2,11,61,3,0,0,0,1,2,0,0,0.025974025974026,0.155844155844156,0.818181818181818,0.961038961038961,0,0,0.027027027027027,0.148648648648649,0.824324324324324,0.038961038961039,0,0,0,0.333333333333333,0.666666666666667
"25017351100",2017,57,0,0,2,21,34,50,0,0,2,20,28,7,0,0,0,1,6,0,0,0.0350877192982456,0.368421052631579,0.596491228070175,0.87719298245614,0,0,0.04,0.4,0.56,0.12280701754386,0,0,0,0.142857142857143,0.857142857142857
"25017351203",2017,47,0,2,0,18,27,42,0,2,0,15,25,5,0,0,0,3,2,0,0.0425531914893617,0,0.382978723404255,0.574468085106383,0.893617021276596,0,0.0476190476190476,0,0.357142857142857,0.595238095238095,0.106382978723404,0,0,0,0.6,0.4
"25017351204",2017,38,0,0,0,9,29,35,0,0,0,8,27,3,0,0,0,1,2,0,0,0,0.236842105263158,0.763157894736842,0.921052631578947,0,0,0,0.228571428571429,0.771428571428571,0.0789473684210526,0,0,0,0.333333333333333,0.666666666666667
"25017351300",2017,29,0,0,0,10,19,28,0,0,0,10,18,1,0,0,0,0,1,0,0,0,0.344827586206897,0.655172413793103,0.96551724137931,0,0,0,0.357142857142857,0.642857142857143,0.0344827586206897,0,0,0,0,1
"25017351403",2017,37,0,0,5,9,23,30,0,0,4,5,21,7,0,0,1,4,2,0,0,0.135135135135135,0.243243243243243,0.621621621621622,0.810810810810811,0,0,0.133333333333333,0.166666666666667,0.7,0.189189189189189,0,0,0.142857142857143,0.571428571428571,0.285714285714286
"25017351404",2017,33,0,0,2,6,25,30,0,0,2,5,23,3,0,0,0,1,2,0,0,0.0606060606060606,0.181818181818182,0.757575757575758,0.909090909090909,0,0,0.0666666666666667,0.166666666666667,0.766666666666667,0.0909090909090909,0,0,0,0.333333333333333,0.666666666666667
"25017351500",2017,39,0,0,5,9,25,37,0,0,5,8,24,2,0,0,0,1,1,0,0,0.128205128205128,0.230769230769231,0.641025641025641,0.948717948717949,0,0,0.135135135135135,0.216216216216216,0.648648648648649,0.0512820512820513,0,0,0,0.5,0.5
"25017352101",2017,35,0,0,5,6,24,33,0,0,5,6,22,2,0,0,0,0,2,0,0,0.142857142857143,0.171428571428571,0.685714285714286,0.942857142857143,0,0,0.151515151515152,0.181818181818182,0.666666666666667,0.0571428571428571,0,0,0,0,1
"25017352102",2017,35,0,0,0,3,32,30,0,0,0,3,27,5,0,0,0,0,5,0,0,0,0.0857142857142857,0.914285714285714,0.857142857142857,0,0,0,0.1,0.9,0.142857142857143,0,0,0,0,1
"25017352200",2017,9,0,0,4,4,1,7,0,0,4,2,1,2,0,0,0,2,0,0,0,0.444444444444444,0.444444444444444,0.111111111111111,0.777777777777778,0,0,0.571428571428571,0.285714285714286,0.142857142857143,0.222222222222222,0,0,0,1,0
"25017352300",2017,16,0,0,1,5,10,16,0,0,1,5,10,0,0,0,0,0,0,0,0,0.0625,0.3125,0.625,1,0,0,0.0625,0.3125,0.625,0,0,0,0,0,0
"25017352400",2017,10,0,0,2,1,7,9,0,0,2,0,7,1,0,0,0,1,0,0,0,0.2,0.1,0.7,0.9,0,0,0.222222222222222,0,0.777777777777778,0.1,0,0,0,1,0
"25017352500",2017,18,0,0,0,3,15,15,0,0,0,3,12,3,0,0,0,0,3,0,0,0,0.166666666666667,0.833333333333333,0.833333333333333,0,0,0,0.2,0.8,0.166666666666667,0,0,0,0,1
"25017352600",2017,11,0,0,0,4,7,11,0,0,0,4,7,0,0,0,0,0,0,0,0,0,0.363636363636364,0.636363636363636,1,0,0,0,0.363636363636364,0.636363636363636,0,0,0,0,0,0
"25017352700",2017,11,0,0,1,2,8,11,0,0,1,2,8,0,0,0,0,0,0,0,0,0.0909090909090909,0.181818181818182,0.727272727272727,1,0,0,0.0909090909090909,0.181818181818182,0.727272727272727,0,0,0,0,0,0
"25017352800",2017,24,0,0,3,8,13,21,0,0,2,7,12,3,0,0,1,1,1,0,0,0.125,0.333333333333333,0.541666666666667,0.875,0,0,0.0952380952380952,0.333333333333333,0.571428571428571,0.125,0,0,0.333333333333333,0.333333333333333,0.333333333333333
"25017352900",2017,34,0,0,0,5,29,30,0,0,0,5,25,4,0,0,0,0,4,0,0,0,0.147058823529412,0.852941176470588,0.882352941176471,0,0,0,0.166666666666667,0.833333333333333,0.117647058823529,0,0,0,0,1
"25017353000",2017,17,0,0,3,6,8,16,0,0,2,6,8,1,0,0,1,0,0,0,0,0.176470588235294,0.352941176470588,0.470588235294118,0.941176470588235,0,0,0.125,0.375,0.5,0.0588235294117647,0,0,1,0,0
"25017353101",2017,6,0,0,1,0,5,5,0,0,1,0,4,1,0,0,0,0,1,0,0,0.166666666666667,0,0.833333333333333,0.833333333333333,0,0,0.2,0,0.8,0.166666666666667,0,0,0,0,1
"25017353200",2017,23,0,0,3,5,15,19,0,0,3,4,12,4,0,0,0,1,3,0,0,0.130434782608696,0.217391304347826,0.652173913043478,0.826086956521739,0,0,0.157894736842105,0.210526315789474,0.631578947368421,0.173913043478261,0,0,0,0.25,0.75
"25017353300",2017,28,0,0,2,8,18,27,0,0,2,7,18,1,0,0,0,1,0,0,0,0.0714285714285714,0.285714285714286,0.642857142857143,0.964285714285714,0,0,0.0740740740740741,0.259259259259259,0.666666666666667,0.0357142857142857,0,0,0,1,0
"25017353400",2017,27,0,0,1,3,23,27,0,0,1,3,23,0,0,0,0,0,0,0,0,0.037037037037037,0.111111111111111,0.851851851851852,1,0,0,0.037037037037037,0.111111111111111,0.851851851851852,0,0,0,0,0,0
"25017353500",2017,11,0,0,0,0,11,11,0,0,0,0,11,0,0,0,0,0,0,0,0,0,0,1,1,0,0,0,0,1,0,0,0,0,0,0
"25017353600",2017,14,0,0,0,2,12,14,0,0,0,2,12,0,0,0,0,0,0,0,0,0,0.142857142857143,0.857142857142857,1,0,0,0,0.142857142857143,0.857142857142857,0,0,0,0,0,0
"25017353700",2017,14,0,0,0,1,13,14,0,0,0,1,13,0,0,0,0,0,0,0,0,0,0.0714285714285714,0.928571428571429,1,0,0,0,0.0714285714285714,0.928571428571429,0,0,0,0,0,0
"25017353800",2017,26,0,0,3,4,19,24,0,0,3,3,18,2,0,0,0,1,1,0,0,0.115384615384615,0.153846153846154,0.730769230769231,0.923076923076923,0,0,0.125,0.125,0.75,0.0769230769230769,0,0,0,0.5,0.5
"25017353900",2017,5,0,0,0,0,5,4,0,0,0,0,4,1,0,0,0,0,1,0,0,0,0,1,0.8,0,0,0,0,1,0.2,0,0,0,0,1
"25017354000",2017,25,0,0,3,4,18,24,0,0,3,4,17,1,0,0,0,0,1,0,0,0.12,0.16,0.72,0.96,0,0,0.125,0.166666666666667,0.708333333333333,0.04,0,0,0,0,1
"25017354100",2017,14,0,0,0,1,13,14,0,0,0,1,13,0,0,0,0,0,0,0,0,0,0.0714285714285714,0.928571428571429,1,0,0,0,0.0714285714285714,0.928571428571429,0,0,0,0,0,0
"25017354200",2017,28,0,0,1,0,27,25,0,0,1,0,24,3,0,0,0,0,3,0,0,0.0357142857142857,0,0.964285714285714,0.892857142857143,0,0,0.04,0,0.96,0.107142857142857,0,0,0,0,1
"25017354300",2017,28,0,0,3,6,19,28,0,0,3,6,19,0,0,0,0,0,0,0,0,0.107142857142857,0.214285714285714,0.678571428571429,1,0,0,0.107142857142857,0.214285714285714,0.678571428571429,0,0,0,0,0,0
"25017354400",2017,19,0,0,0,4,15,19,0,0,0,4,15,0,0,0,0,0,0,0,0,0,0.210526315789474,0.789473684210526,1,0,0,0,0.210526315789474,0.789473684210526,0,0,0,0,0,0
"25017354500",2017,11,0,0,0,2,9,9,0,0,0,2,7,2,0,0,0,0,2,0,0,0,0.181818181818182,0.818181818181818,0.818181818181818,0,0,0,0.222222222222222,0.777777777777778,0.181818181818182,0,0,0,0,1
"25017354600",2017,44,0,0,4,3,37,41,0,0,4,3,34,3,0,0,0,0,3,0,0,0.0909090909090909,0.0681818181818182,0.840909090909091,0.931818181818182,0,0,0.0975609756097561,0.0731707317073171,0.829268292682927,0.0681818181818182,0,0,0,0,1
"25017354700",2017,38,0,0,7,2,29,36,0,0,6,2,28,2,0,0,1,0,1,0,0,0.184210526315789,0.0526315789473684,0.763157894736842,0.947368421052632,0,0,0.166666666666667,0.0555555555555556,0.777777777777778,0.0526315789473684,0,0,0.5,0,0.5
"25017354800",2017,19,0,0,1,4,14,19,0,0,1,4,14,0,0,0,0,0,0,0,0,0.0526315789473684,0.210526315789474,0.736842105263158,1,0,0,0.0526315789473684,0.210526315789474,0.736842105263158,0,0,0,0,0,0
"25017354900",2017,37,0,0,4,7,26,34,0,0,4,7,23,3,0,0,0,0,3,0,0,0.108108108108108,0.189189189189189,0.702702702702703,0.918918918918919,0,0,0.117647058823529,0.205882352941176,0.676470588235294,0.0810810810810811,0,0,0,0,1
"25017355000",2017,29,0,0,1,6,22,28,0,0,1,5,22,1,0,0,0,1,0,0,0,0.0344827586206897,0.206896551724138,0.758620689655172,0.96551724137931,0,0,0.0357142857142857,0.178571428571429,0.785714285714286,0.0344827586206897,0,0,0,1,0
"25017356100",2017,35,0,0,1,5,29,35,0,0,1,5,29,0,0,0,0,0,0,0,0,0.0285714285714286,0.142857142857143,0.828571428571429,1,0,0,0.0285714285714286,0.142857142857143,0.828571428571429,0,0,0,0,0,0
"25017356300",2017,56,0,0,3,17,36,52,0,0,2,16,34,4,0,0,1,1,2,0,0,0.0535714285714286,0.303571428571429,0.642857142857143,0.928571428571429,0,0,0.0384615384615385,0.307692307692308,0.653846153846154,0.0714285714285714,0,0,0.25,0.25,0.5
"25017356400",2017,93,0,1,1,16,75,90,0,0,1,16,73,3,0,1,0,0,2,0,0.010752688172043,0.010752688172043,0.172043010752688,0.806451612903226,0.967741935483871,0,0,0.0111111111111111,0.177777777777778,0.811111111111111,0.032258064516129,0,0.333333333333333,0,0,0.666666666666667
"25017356500",2017,117,0,0,7,29,81,111,0,0,5,27,79,6,0,0,2,2,2,0,0,0.0598290598290598,0.247863247863248,0.692307692307692,0.948717948717949,0,0,0.045045045045045,0.243243243243243,0.711711711711712,0.0512820512820513,0,0,0.333333333333333,0.333333333333333,0.333333333333333
"25017356601",2017,61,0,0,3,14,44,58,0,0,3,13,42,3,0,0,0,1,2,0,0,0.0491803278688525,0.229508196721311,0.721311475409836,0.950819672131147,0,0,0.0517241379310345,0.224137931034483,0.724137931034483,0.0491803278688525,0,0,0,0.333333333333333,0.666666666666667
"25017356602",2017,69,0,0,0,11,58,66,0,0,0,11,55,3,0,0,0,0,3,0,0,0,0.159420289855072,0.840579710144927,0.956521739130435,0,0,0,0.166666666666667,0.833333333333333,0.0434782608695652,0,0,0,0,1
"25017356701",2017,49,0,0,2,13,34,47,0,0,1,12,34,2,0,0,1,1,0,0,0,0.0408163265306122,0.26530612244898,0.693877551020408,0.959183673469388,0,0,0.0212765957446809,0.25531914893617,0.723404255319149,0.0408163265306122,0,0,0.5,0.5,0
"25017356702",2017,87,0,0,3,15,69,87,0,0,3,15,69,0,0,0,0,0,0,0,0,0.0344827586206897,0.172413793103448,0.793103448275862,1,0,0,0.0344827586206897,0.172413793103448,0.793103448275862,0,0,0,0,0,0
"25017357100",2017,56,0,0,0,4,52,55,0,0,0,4,51,1,0,0,0,0,1,0,0,0,0.0714285714285714,0.928571428571429,0.982142857142857,0,0,0,0.0727272727272727,0.927272727272727,0.0178571428571429,0,0,0,0,1
"25017357200",2017,28,0,0,0,6,22,27,0,0,0,6,21,1,0,0,0,0,1,0,0,0,0.214285714285714,0.785714285714286,0.964285714285714,0,0,0,0.222222222222222,0.777777777777778,0.0357142857142857,0,0,0,0,1
"25017357300",2017,33,0,0,2,5,26,31,0,0,2,4,25,2,0,0,0,1,1,0,0,0.0606060606060606,0.151515151515152,0.787878787878788,0.939393939393939,0,0,0.0645161290322581,0.129032258064516,0.806451612903226,0.0606060606060606,0,0,0,0.5,0.5
"25017357400",2017,33,0,1,0,2,30,30,0,1,0,2,27,3,0,0,0,0,3,0,0.0303030303030303,0,0.0606060606060606,0.909090909090909,0.909090909090909,0,0.0333333333333333,0,0.0666666666666667,0.9,0.0909090909090909,0,0,0,0,1
"25017357500",2017,22,0,0,1,4,17,22,0,0,1,4,17,0,0,0,0,0,0,0,0,0.0454545454545455,0.181818181818182,0.772727272727273,1,0,0,0.0454545454545455,0.181818181818182,0.772727272727273,0,0,0,0,0,0
"25017357600",2017,20,0,0,2,4,14,20,0,0,2,4,14,0,0,0,0,0,0,0,0,0.1,0.2,0.7,1,0,0,0.1,0.2,0.7,0,0,0,0,0,0
"25017357700",2017,32,0,0,1,5,26,31,0,0,1,5,25,1,0,0,0,0,1,0,0,0.03125,0.15625,0.8125,0.96875,0,0,0.032258064516129,0.161290322580645,0.806451612903226,0.03125,0,0,0,0,1
"25017357800",2017,48,0,0,0,2,46,46,0,0,0,1,45,2,0,0,0,1,1,0,0,0,0.0416666666666667,0.958333333333333,0.958333333333333,0,0,0,0.0217391304347826,0.978260869565217,0.0416666666666667,0,0,0,0.5,0.5
"25017358100",2017,70,0,0,3,3,64,67,0,0,2,3,62,3,0,0,1,0,2,0,0,0.0428571428571429,0.0428571428571429,0.914285714285714,0.957142857142857,0,0,0.0298507462686567,0.0447761194029851,0.925373134328358,0.0428571428571429,0,0,0.333333333333333,0,0.666666666666667
"25017358300",2017,65,0,0,0,12,53,62,0,0,0,11,51,3,0,0,0,1,2,0,0,0,0.184615384615385,0.815384615384615,0.953846153846154,0,0,0,0.17741935483871,0.82258064516129,0.0461538461538462,0,0,0,0.333333333333333,0.666666666666667
"25017358400",2017,79,0,0,1,8,70,71,0,0,1,6,64,8,0,0,0,2,6,0,0,0.0126582278481013,0.10126582278481,0.886075949367089,0.89873417721519,0,0,0.0140845070422535,0.0845070422535211,0.901408450704225,0.10126582278481,0,0,0,0.25,0.75
"25017358500",2017,62,0,0,3,2,57,57,0,0,3,2,52,5,0,0,0,0,5,0,0,0.0483870967741935,0.032258064516129,0.919354838709677,0.919354838709677,0,0,0.0526315789473684,0.0350877192982456,0.912280701754386,0.0806451612903226,0,0,0,0,1
"25017358600",2017,72,0,0,1,4,67,65,0,0,0,3,62,7,0,0,1,1,5,0,0,0.0138888888888889,0.0555555555555556,0.930555555555556,0.902777777777778,0,0,0,0.0461538461538462,0.953846153846154,0.0972222222222222,0,0,0.142857142857143,0.142857142857143,0.714285714285714
"25017358700",2017,83,0,0,1,11,71,80,0,0,1,9,70,3,0,0,0,2,1,0,0,0.0120481927710843,0.132530120481928,0.855421686746988,0.963855421686747,0,0,0.0125,0.1125,0.875,0.036144578313253,0,0,0,0.666666666666667,0.333333333333333
"25017359100",2017,71,0,0,2,11,58,65,0,0,1,10,54,6,0,0,1,1,4,0,0,0.028169014084507,0.154929577464789,0.816901408450704,0.915492957746479,0,0,0.0153846153846154,0.153846153846154,0.830769230769231,0.0845070422535211,0,0,0.166666666666667,0.166666666666667,0.666666666666667
"25017359300",2017,121,1,0,2,23,95,113,0,0,1,20,92,8,1,0,1,3,3,0.00826446280991736,0,0.0165289256198347,0.190082644628099,0.785123966942149,0.933884297520661,0,0,0.00884955752212389,0.176991150442478,0.814159292035398,0.0661157024793388,0.125,0,0.125,0.375,0.375
"25017360200",2017,57,0,0,4,6,47,52,0,0,3,6,43,5,0,0,1,0,4,0,0,0.0701754385964912,0.105263157894737,0.824561403508772,0.912280701754386,0,0,0.0576923076923077,0.115384615384615,0.826923076923077,0.087719298245614,0,0,0.2,0,0.8
"25017361100",2017,73,1,0,4,13,55,69,0,0,3,13,53,4,1,0,1,0,2,0.0136986301369863,0,0.0547945205479452,0.178082191780822,0.753424657534247,0.945205479452055,0,0,0.0434782608695652,0.188405797101449,0.768115942028985,0.0547945205479452,0.25,0,0.25,0,0.5
"25017361200",2017,74,0,0,1,9,64,70,0,0,1,9,60,4,0,0,0,0,4,0,0,0.0135135135135135,0.121621621621622,0.864864864864865,0.945945945945946,0,0,0.0142857142857143,0.128571428571429,0.857142857142857,0.0540540540540541,0,0,0,0,1
"25017361300",2017,70,0,0,5,8,57,66,0,0,5,7,54,4,0,0,0,1,3,0,0,0.0714285714285714,0.114285714285714,0.814285714285714,0.942857142857143,0,0,0.0757575757575758,0.106060606060606,0.818181818181818,0.0571428571428571,0,0,0,0.25,0.75
"25017362100",2017,75,0,0,0,7,68,66,0,0,0,6,60,9,0,0,0,1,8,0,0,0,0.0933333333333333,0.906666666666667,0.88,0,0,0,0.0909090909090909,0.909090909090909,0.12,0,0,0,0.111111111111111,0.888888888888889
"25017363102",2017,112,0,1,21,28,62,104,0,1,16,27,60,8,0,0,5,1,2,0,0.00892857142857143,0.1875,0.25,0.553571428571429,0.928571428571429,0,0.00961538461538462,0.153846153846154,0.259615384615385,0.576923076923077,0.0714285714285714,0,0,0.625,0.125,0.25
"25017363103",2017,68,0,0,7,8,53,59,0,0,6,6,47,9,0,0,1,2,6,0,0,0.102941176470588,0.117647058823529,0.779411764705882,0.867647058823529,0,0,0.101694915254237,0.101694915254237,0.796610169491525,0.132352941176471,0,0,0.111111111111111,0.222222222222222,0.666666666666667
"25017363104",2017,113,0,0,11,21,81,106,0,0,10,20,76,7,0,0,1,1,5,0,0,0.0973451327433628,0.185840707964602,0.716814159292035,0.938053097345133,0,0,0.0943396226415094,0.188679245283019,0.716981132075472,0.0619469026548673,0,0,0.142857142857143,0.142857142857143,0.714285714285714
"25017363201",2017,47,0,0,4,11,32,44,0,0,3,11,30,3,0,0,1,0,2,0,0,0.0851063829787234,0.234042553191489,0.680851063829787,0.936170212765957,0,0,0.0681818181818182,0.25,0.681818181818182,0.0638297872340425,0,0,0.333333333333333,0,0.666666666666667
"25017363202",2017,68,0,0,7,16,45,66,0,0,6,16,44,2,0,0,1,0,1,0,0,0.102941176470588,0.235294117647059,0.661764705882353,0.970588235294118,0,0,0.0909090909090909,0.242424242424242,0.666666666666667,0.0294117647058824,0,0,0.5,0,0.5
"25017364101",2017,105,0,0,24,48,33,97,0,0,20,46,31,8,0,0,4,2,2,0,0,0.228571428571429,0.457142857142857,0.314285714285714,0.923809523809524,0,0,0.206185567010309,0.474226804123711,0.319587628865979,0.0761904761904762,0,0,0.5,0.25,0.25
"25017364102",2017,94,0,2,18,37,37,91,0,1,18,35,37,3,0,1,0,2,0,0,0.0212765957446809,0.191489361702128,0.393617021276596,0.393617021276596,0.968085106382979,0,0.010989010989011,0.197802197802198,0.384615384615385,0.406593406593407,0.0319148936170213,0,0.333333333333333,0,0.666666666666667,0
"25017365100",2017,113,0,0,3,9,101,105,0,0,3,8,94,8,0,0,0,1,7,0,0,0.0265486725663717,0.079646017699115,0.893805309734513,0.929203539823009,0,0,0.0285714285714286,0.0761904761904762,0.895238095238095,0.0707964601769911,0,0,0,0.125,0.875
"25017365201",2017,115,0,0,1,25,89,103,0,0,1,22,80,12,0,0,0,3,9,0,0,0.00869565217391304,0.217391304347826,0.773913043478261,0.895652173913044,0,0,0.00970873786407767,0.213592233009709,0.776699029126214,0.104347826086957,0,0,0,0.25,0.75
"25017365202",2017,58,0,0,2,6,50,54,0,0,2,5,47,4,0,0,0,1,3,0,0,0.0344827586206897,0.103448275862069,0.862068965517241,0.931034482758621,0,0,0.037037037037037,0.0925925925925926,0.87037037037037,0.0689655172413793,0,0,0,0.25,0.75
"25017366100",2017,58,0,0,4,17,37,52,0,0,3,14,35,6,0,0,1,3,2,0,0,0.0689655172413793,0.293103448275862,0.637931034482759,0.896551724137931,0,0,0.0576923076923077,0.269230769230769,0.673076923076923,0.103448275862069,0,0,0.166666666666667,0.5,0.333333333333333
"25017366201",2017,56,0,1,1,5,49,55,0,1,1,4,49,1,0,0,0,1,0,0,0.0178571428571429,0.0178571428571429,0.0892857142857143,0.875,0.982142857142857,0,0.0181818181818182,0.0181818181818182,0.0727272727272727,0.890909090909091,0.0178571428571429,0,0,0,1,0
"25017366202",2017,75,0,0,0,6,69,72,0,0,0,6,66,3,0,0,0,0,3,0,0,0,0.08,0.92,0.96,0,0,0,0.0833333333333333,0.916666666666667,0.04,0,0,0,0,1
"25017367100",2017,68,0,0,1,0,67,61,0,0,1,0,60,7,0,0,0,0,7,0,0,0.0147058823529412,0,0.985294117647059,0.897058823529412,0,0,0.0163934426229508,0,0.983606557377049,0.102941176470588,0,0,0,0,1
"25017367200",2017,114,0,0,3,6,105,105,0,0,3,6,96,9,0,0,0,0,9,0,0,0.0263157894736842,0.0526315789473684,0.921052631578947,0.921052631578947,0,0,0.0285714285714286,0.0571428571428571,0.914285714285714,0.0789473684210526,0,0,0,0,1
"25017368101",2017,45,0,0,9,14,22,44,0,0,8,14,22,1,0,0,1,0,0,0,0,0.2,0.311111111111111,0.488888888888889,0.977777777777778,0,0,0.181818181818182,0.318181818181818,0.5,0.0222222222222222,0,0,1,0,0
"25017368102",2017,69,0,0,7,27,35,65,0,0,6,26,33,4,0,0,1,1,2,0,0,0.101449275362319,0.391304347826087,0.507246376811594,0.942028985507246,0,0,0.0923076923076923,0.4,0.507692307692308,0.0579710144927536,0,0,0.25,0.25,0.5
"25017368200",2017,38,0,1,8,12,17,37,0,0,8,12,17,1,0,1,0,0,0,0,0.0263157894736842,0.210526315789474,0.315789473684211,0.447368421052632,0.973684210526316,0,0,0.216216216216216,0.324324324324324,0.459459459459459,0.0263157894736842,0,1,0,0,0
"25017368300",2017,70,0,0,11,27,32,62,0,0,11,21,30,8,0,0,0,6,2,0,0,0.157142857142857,0.385714285714286,0.457142857142857,0.885714285714286,0,0,0.17741935483871,0.338709677419355,0.483870967741935,0.114285714285714,0,0,0,0.75,0.25
"25017368400",2017,54,0,1,4,14,35,50,0,1,4,13,32,4,0,0,0,1,3,0,0.0185185185185185,0.0740740740740741,0.259259259259259,0.648148148148148,0.925925925925926,0,0.02,0.08,0.26,0.64,0.0740740740740741,0,0,0,0.25,0.75
"25017368500",2017,22,0,0,5,7,10,20,0,0,5,6,9,2,0,0,0,1,1,0,0,0.227272727272727,0.318181818181818,0.454545454545455,0.909090909090909,0,0,0.25,0.3,0.45,0.0909090909090909,0,0,0,0.5,0.5
"25017368600",2017,45,0,0,5,20,20,42,0,0,5,18,19,3,0,0,0,2,1,0,0,0.111111111111111,0.444444444444444,0.444444444444444,0.933333333333333,0,0,0.119047619047619,0.428571428571429,0.452380952380952,0.0666666666666667,0,0,0,0.666666666666667,0.333333333333333
"25017368700",2017,21,0,0,1,12,8,20,0,0,1,11,8,1,0,0,0,1,0,0,0,0.0476190476190476,0.571428571428571,0.380952380952381,0.952380952380952,0,0,0.05,0.55,0.4,0.0476190476190476,0,0,0,1,0
"25017368800",2017,58,0,0,10,22,26,55,0,0,10,21,24,3,0,0,0,1,2,0,0,0.172413793103448,0.379310344827586,0.448275862068966,0.948275862068966,0,0,0.181818181818182,0.381818181818182,0.436363636363636,0.0517241379310345,0,0,0,0.333333333333333,0.666666666666667
"25017368901",2017,61,0,1,5,19,36,59,0,1,5,19,34,2,0,0,0,0,2,0,0.0163934426229508,0.0819672131147541,0.311475409836066,0.590163934426229,0.967213114754098,0,0.0169491525423729,0.0847457627118644,0.322033898305085,0.576271186440678,0.0327868852459016,0,0,0,0,1
"25017368902",2017,32,0,0,4,11,17,31,0,0,4,10,17,1,0,0,0,1,0,0,0,0.125,0.34375,0.53125,0.96875,0,0,0.129032258064516,0.32258064516129,0.548387096774194,0.03125,0,0,0,1,0
"25017369000",2017,27,0,0,5,15,7,24,0,0,4,13,7,3,0,0,1,2,0,0,0,0.185185185185185,0.555555555555556,0.259259259259259,0.888888888888889,0,0,0.166666666666667,0.541666666666667,0.291666666666667,0.111111111111111,0,0,0.333333333333333,0.666666666666667,0
"25017369100",2017,68,0,0,4,27,37,64,0,0,4,23,37,4,0,0,0,4,0,0,0,0.0588235294117647,0.397058823529412,0.544117647058823,0.941176470588235,0,0,0.0625,0.359375,0.578125,0.0588235294117647,0,0,0,1,0
"25017370101",2017,91,1,2,8,26,54,82,1,0,8,23,50,9,0,2,0,3,4,0.010989010989011,0.021978021978022,0.0879120879120879,0.285714285714286,0.593406593406593,0.901098901098901,0.0121951219512195,0,0.0975609756097561,0.280487804878049,0.609756097560976,0.0989010989010989,0,0.222222222222222,0,0.333333333333333,0.444444444444444
"25017370102",2017,90,0,0,10,28,52,87,0,0,9,26,52,3,0,0,1,2,0,0,0,0.111111111111111,0.311111111111111,0.577777777777778,0.966666666666667,0,0,0.103448275862069,0.298850574712644,0.597701149425287,0.0333333333333333,0,0,0.333333333333333,0.666666666666667,0
"25017370201",2017,41,0,0,1,13,27,39,0,0,1,13,25,2,0,0,0,0,2,0,0,0.024390243902439,0.317073170731707,0.658536585365854,0.951219512195122,0,0,0.0256410256410256,0.333333333333333,0.641025641025641,0.0487804878048781,0,0,0,0,1
"25017370202",2017,64,0,1,5,9,49,61,0,1,3,8,49,3,0,0,2,1,0,0,0.015625,0.078125,0.140625,0.765625,0.953125,0,0.0163934426229508,0.0491803278688525,0.131147540983607,0.80327868852459,0.046875,0,0,0.666666666666667,0.333333333333333,0
"25017370300",2017,36,0,0,1,9,26,35,0,0,1,9,25,1,0,0,0,0,1,0,0,0.0277777777777778,0.25,0.722222222222222,0.972222222222222,0,0,0.0285714285714286,0.257142857142857,0.714285714285714,0.0277777777777778,0,0,0,0,1
"25017370400",2017,50,0,2,8,9,31,41,0,1,5,7,28,9,0,1,3,2,3,0,0.04,0.16,0.18,0.62,0.82,0,0.024390243902439,0.121951219512195,0.170731707317073,0.682926829268293,0.18,0,0.111111111111111,0.333333333333333,0.222222222222222,0.333333333333333
"25017373100",2017,55,0,1,3,10,41,50,0,1,2,9,38,5,0,0,1,1,3,0,0.0181818181818182,0.0545454545454545,0.181818181818182,0.745454545454545,0.909090909090909,0,0.02,0.04,0.18,0.76,0.0909090909090909,0,0,0.2,0.2,0.6
"25017373200",2017,40,0,0,2,11,27,37,0,0,1,10,26,3,0,0,1,1,1,0,0,0.05,0.275,0.675,0.925,0,0,0.027027027027027,0.27027027027027,0.702702702702703,0.075,0,0,0.333333333333333,0.333333333333333,0.333333333333333
"25017373300",2017,63,1,0,15,7,40,51,0,0,13,5,33,12,1,0,2,2,7,0.0158730158730159,0,0.238095238095238,0.111111111111111,0.634920634920635,0.80952380952381,0,0,0.254901960784314,0.0980392156862745,0.647058823529412,0.19047619047619,0.0833333333333333,0,0.166666666666667,0.166666666666667,0.583333333333333
"25017373400",2017,43,0,0,1,4,38,42,0,0,1,3,38,1,0,0,0,1,0,0,0,0.0232558139534884,0.0930232558139535,0.883720930232558,0.976744186046512,0,0,0.0238095238095238,0.0714285714285714,0.904761904761905,0.0232558139534884,0,0,0,1,0
"25017373500",2017,66,0,0,5,5,56,65,0,0,4,5,56,1,0,0,1,0,0,0,0,0.0757575757575758,0.0757575757575758,0.848484848484849,0.984848484848485,0,0,0.0615384615384615,0.0769230769230769,0.861538461538462,0.0151515151515152,0,0,1,0,0
"25017373600",2017,39,0,0,3,3,33,36,0,0,3,3,30,3,0,0,0,0,3,0,0,0.0769230769230769,0.0769230769230769,0.846153846153846,0.923076923076923,0,0,0.0833333333333333,0.0833333333333333,0.833333333333333,0.0769230769230769,0,0,0,0,1
"25017373700",2017,47,0,0,0,5,42,44,0,0,0,5,39,3,0,0,0,0,3,0,0,0,0.106382978723404,0.893617021276596,0.936170212765957,0,0,0,0.113636363636364,0.886363636363636,0.0638297872340425,0,0,0,0,1
"25017373800",2017,62,0,0,4,6,52,58,0,0,4,6,48,4,0,0,0,0,4,0,0,0.0645161290322581,0.0967741935483871,0.838709677419355,0.935483870967742,0,0,0.0689655172413793,0.103448275862069,0.827586206896552,0.0645161290322581,0,0,0,0,1
"25017373900",2017,78,0,0,7,9,62,75,0,0,7,9,59,3,0,0,0,0,3,0,0,0.0897435897435897,0.115384615384615,0.794871794871795,0.961538461538462,0,0,0.0933333333333333,0.12,0.786666666666667,0.0384615384615385,0,0,0,0,1
"25017374000",2017,74,0,1,3,6,64,66,0,1,2,5,58,8,0,0,1,1,6,0,0.0135135135135135,0.0405405405405405,0.0810810810810811,0.864864864864865,0.891891891891892,0,0.0151515151515152,0.0303030303030303,0.0757575757575758,0.878787878787879,0.108108108108108,0,0,0.125,0.125,0.75
"25017374100",2017,72,0,0,7,12,53,61,0,0,6,8,47,11,0,0,1,4,6,0,0,0.0972222222222222,0.166666666666667,0.736111111111111,0.847222222222222,0,0,0.0983606557377049,0.131147540983607,0.770491803278688,0.152777777777778,0,0,0.0909090909090909,0.363636363636364,0.545454545454545
"25017374200",2017,39,0,0,0,1,38,39,0,0,0,1,38,0,0,0,0,0,0,0,0,0,0.0256410256410256,0.974358974358974,1,0,0,0,0.0256410256410256,0.974358974358974,0,0,0,0,0,0
"25017374300",2017,41,0,0,0,2,39,38,0,0,0,2,36,3,0,0,0,0,3,0,0,0,0.0487804878048781,0.951219512195122,0.926829268292683,0,0,0,0.0526315789473684,0.947368421052632,0.0731707317073171,0,0,0,0,1
"25017374400",2017,54,0,0,0,3,51,50,0,0,0,3,47,4,0,0,0,0,4,0,0,0,0.0555555555555556,0.944444444444444,0.925925925925926,0,0,0,0.06,0.94,0.0740740740740741,0,0,0,0,1
"25017374500",2017,47,0,0,0,7,40,46,0,0,0,7,39,1,0,0,0,0,1,0,0,0,0.148936170212766,0.851063829787234,0.978723404255319,0,0,0,0.152173913043478,0.847826086956522,0.0212765957446809,0,0,0,0,1
"25017374600",2017,59,1,0,4,10,44,52,0,0,2,9,41,7,1,0,2,1,3,0.0169491525423729,0,0.0677966101694915,0.169491525423729,0.745762711864407,0.88135593220339,0,0,0.0384615384615385,0.173076923076923,0.788461538461538,0.11864406779661,0.142857142857143,0,0.285714285714286,0.142857142857143,0.428571428571429
"25017374700",2017,50,0,0,1,7,42,47,0,0,1,7,39,3,0,0,0,0,3,0,0,0.02,0.14,0.84,0.94,0,0,0.0212765957446809,0.148936170212766,0.829787234042553,0.06,0,0,0,0,1
"25017374800",2017,41,0,0,1,6,34,38,0,0,1,6,31,3,0,0,0,0,3,0,0,0.024390243902439,0.146341463414634,0.829268292682927,0.926829268292683,0,0,0.0263157894736842,0.157894736842105,0.815789473684211,0.0731707317073171,0,0,0,0,1
"25017382100",2017,63,0,0,5,10,48,60,0,0,4,9,47,3,0,0,1,1,1,0,0,0.0793650793650794,0.158730158730159,0.761904761904762,0.952380952380952,0,0,0.0666666666666667,0.15,0.783333333333333,0.0476190476190476,0,0,0.333333333333333,0.333333333333333,0.333333333333333
"25017382200",2017,68,1,0,5,23,39,65,0,0,5,22,38,3,1,0,0,1,1,0.0147058823529412,0,0.0735294117647059,0.338235294117647,0.573529411764706,0.955882352941177,0,0,0.0769230769230769,0.338461538461538,0.584615384615385,0.0441176470588235,0.333333333333333,0,0,0.333333333333333,0.333333333333333
"25017382300",2017,98,0,0,2,15,81,91,0,0,1,12,78,7,0,0,1,3,3,0,0,0.0204081632653061,0.153061224489796,0.826530612244898,0.928571428571429,0,0,0.010989010989011,0.131868131868132,0.857142857142857,0.0714285714285714,0,0,0.142857142857143,0.428571428571429,0.428571428571429
"25017382400",2017,58,0,0,5,7,46,58,0,0,5,7,46,0,0,0,0,0,0,0,0,0.0862068965517241,0.120689655172414,0.793103448275862,1,0,0,0.0862068965517241,0.120689655172414,0.793103448275862,0,0,0,0,0,0
"25017382500",2017,55,0,0,2,25,28,48,0,0,1,22,25,7,0,0,1,3,3,0,0,0.0363636363636364,0.454545454545455,0.509090909090909,0.872727272727273,0,0,0.0208333333333333,0.458333333333333,0.520833333333333,0.127272727272727,0,0,0.142857142857143,0.428571428571429,0.428571428571429
"25017382601",2017,91,0,0,19,35,37,85,0,0,18,33,34,6,0,0,1,2,3,0,0,0.208791208791209,0.384615384615385,0.406593406593407,0.934065934065934,0,0,0.211764705882353,0.388235294117647,0.4,0.0659340659340659,0,0,0.166666666666667,0.333333333333333,0.5
"25017382602",2017,46,0,0,2,12,32,42,0,0,1,11,30,4,0,0,1,1,2,0,0,0.0434782608695652,0.260869565217391,0.695652173913043,0.91304347826087,0,0,0.0238095238095238,0.261904761904762,0.714285714285714,0.0869565217391304,0,0,0.25,0.25,0.5
"25017383101",2017,16,0,2,8,3,3,14,0,1,7,3,3,2,0,1,1,0,0,0,0.125,0.5,0.1875,0.1875,0.875,0,0.0714285714285714,0.5,0.214285714285714,0.214285714285714,0.125,0,0.5,0.5,0,0
"25017383102",2017,20,0,1,12,5,2,17,0,0,10,5,2,3,0,1,2,0,0,0,0.05,0.6,0.25,0.1,0.85,0,0,0.588235294117647,0.294117647058824,0.117647058823529,0.15,0,0.333333333333333,0.666666666666667,0,0
"25017383200",2017,76,0,1,28,31,16,64,0,0,26,26,12,12,0,1,2,5,4,0,0.0131578947368421,0.368421052631579,0.407894736842105,0.210526315789474,0.842105263157895,0,0,0.40625,0.40625,0.1875,0.157894736842105,0,0.0833333333333333,0.166666666666667,0.416666666666667,0.333333333333333
"25017383300",2017,30,0,0,9,11,10,25,0,0,6,10,9,5,0,0,3,1,1,0,0,0.3,0.366666666666667,0.333333333333333,0.833333333333333,0,0,0.24,0.4,0.36,0.166666666666667,0,0,0.6,0.2,0.2
"25017383400",2017,75,0,0,27,27,21,69,0,0,24,24,21,6,0,0,3,3,0,0,0,0.36,0.36,0.28,0.92,0,0,0.347826086956522,0.347826086956522,0.304347826086957,0.08,0,0,0.5,0.5,0
"25017383501",2017,20,0,0,8,5,7,19,0,0,7,5,7,1,0,0,1,0,0,0,0,0.4,0.25,0.35,0.95,0,0,0.368421052631579,0.263157894736842,0.368421052631579,0.05,0,0,1,0,0
"25017383502",2017,55,0,1,15,18,21,52,0,1,13,17,21,3,0,0,2,1,0,0,0.0181818181818182,0.272727272727273,0.327272727272727,0.381818181818182,0.945454545454545,0,0.0192307692307692,0.25,0.326923076923077,0.403846153846154,0.0545454545454545,0,0,0.666666666666667,0.333333333333333,0
"25017383600",2017,85,0,0,15,35,35,79,0,0,13,35,31,6,0,0,2,0,4,0,0,0.176470588235294,0.411764705882353,0.411764705882353,0.929411764705882,0,0,0.164556962025316,0.443037974683544,0.392405063291139,0.0705882352941176,0,0,0.333333333333333,0,0.666666666666667
"25017383700",2017,86,0,0,17,34,35,80,0,0,16,30,34,6,0,0,1,4,1,0,0,0.197674418604651,0.395348837209302,0.406976744186047,0.930232558139535,0,0,0.2,0.375,0.425,0.0697674418604651,0,0,0.166666666666667,0.666666666666667,0.166666666666667
"25017383800",2017,121,2,1,23,35,60,117,1,0,22,34,60,4,1,1,1,1,0,0.0165289256198347,0.00826446280991736,0.190082644628099,0.289256198347107,0.495867768595041,0.966942148760331,0.00854700854700855,0,0.188034188034188,0.290598290598291,0.512820512820513,0.0330578512396694,0.25,0.25,0.25,0.25,0
"25017383901",2017,131,0,1,23,43,64,126,0,1,23,41,61,5,0,0,0,2,3,0,0.00763358778625954,0.175572519083969,0.32824427480916,0.488549618320611,0.961832061068702,0,0.00793650793650794,0.182539682539683,0.325396825396825,0.484126984126984,0.0381679389312977,0,0,0,0.4,0.6
"25017383902",2017,95,0,0,4,30,61,90,0,0,4,27,59,5,0,0,0,3,2,0,0,0.0421052631578947,0.315789473684211,0.642105263157895,0.947368421052632,0,0,0.0444444444444444,0.3,0.655555555555556,0.0526315789473684,0,0,0,0.6,0.4
"25017384001",2017,36,0,0,5,15,16,34,0,0,4,14,16,2,0,0,1,1,0,0,0,0.138888888888889,0.416666666666667,0.444444444444444,0.944444444444444,0,0,0.117647058823529,0.411764705882353,0.470588235294118,0.0555555555555556,0,0,0.5,0.5,0
"25017384002",2017,49,0,1,3,20,25,44,0,0,3,19,22,5,0,1,0,1,3,0,0.0204081632653061,0.0612244897959184,0.408163265306122,0.510204081632653,0.897959183673469,0,0,0.0681818181818182,0.431818181818182,0.5,0.102040816326531,0,0.2,0,0.2,0.6
"25017385100",2017,91,0,0,13,32,46,87,0,0,10,32,45,4,0,0,3,0,1,0,0,0.142857142857143,0.351648351648352,0.505494505494505,0.956043956043956,0,0,0.114942528735632,0.367816091954023,0.517241379310345,0.043956043956044,0,0,0.75,0,0.25
"25017385201",2017,47,0,1,8,15,23,43,0,0,8,13,22,4,0,1,0,2,1,0,0.0212765957446809,0.170212765957447,0.319148936170213,0.48936170212766,0.914893617021277,0,0,0.186046511627907,0.302325581395349,0.511627906976744,0.0851063829787234,0,0.25,0,0.5,0.25
"25017385202",2017,226,0,0,44,111,71,204,0,0,37,103,64,22,0,0,7,8,7,0,0,0.194690265486726,0.491150442477876,0.314159292035398,0.902654867256637,0,0,0.181372549019608,0.504901960784314,0.313725490196078,0.0973451327433628,0,0,0.318181818181818,0.363636363636364,0.318181818181818
"25017386100",2017,77,0,0,4,4,69,70,0,0,4,4,62,7,0,0,0,0,7,0,0,0.051948051948052,0.051948051948052,0.896103896103896,0.909090909090909,0,0,0.0571428571428571,0.0571428571428571,0.885714285714286,0.0909090909090909,0,0,0,0,1
"25017387100",2017,76,0,3,14,22,37,70,0,2,13,19,36,6,0,1,1,3,1,0,0.0394736842105263,0.184210526315789,0.289473684210526,0.486842105263158,0.921052631578947,0,0.0285714285714286,0.185714285714286,0.271428571428571,0.514285714285714,0.0789473684210526,0,0.166666666666667,0.166666666666667,0.5,0.166666666666667
"25017387201",2017,119,0,0,16,29,74,109,0,0,16,24,69,10,0,0,0,5,5,0,0,0.134453781512605,0.243697478991597,0.621848739495798,0.915966386554622,0,0,0.146788990825688,0.220183486238532,0.63302752293578,0.0840336134453782,0,0,0,0.5,0.5
"25017387202",2017,67,0,0,12,20,35,62,0,0,9,19,34,5,0,0,3,1,1,0,0,0.17910447761194,0.298507462686567,0.522388059701492,0.925373134328358,0,0,0.145161290322581,0.306451612903226,0.548387096774194,0.0746268656716418,0,0,0.6,0.2,0.2
"25017388100",2017,91,0,3,6,23,59,88,0,3,6,22,57,3,0,0,0,1,2,0,0.032967032967033,0.0659340659340659,0.252747252747253,0.648351648351648,0.967032967032967,0,0.0340909090909091,0.0681818181818182,0.25,0.647727272727273,0.032967032967033,0,0,0,0.333333333333333,0.666666666666667
"25017388200",2017,83,0,3,26,31,23,80,0,2,24,31,23,3,0,1,2,0,0,0,0.036144578313253,0.313253012048193,0.373493975903614,0.27710843373494,0.963855421686747,0,0.025,0.3,0.3875,0.2875,0.036144578313253,0,0.333333333333333,0.666666666666667,0,0
"25017388300",2017,14,0,0,9,4,1,14,0,0,9,4,1,0,0,0,0,0,0,0,0,0.642857142857143,0.285714285714286,0.0714285714285714,1,0,0,0.642857142857143,0.285714285714286,0.0714285714285714,0,0,0,0,0,0
"25019950100",2017,79,0,0,1,0,78,71,0,0,1,0,70,8,0,0,0,0,8,0,0,0.0126582278481013,0,0.987341772151899,0.89873417721519,0,0,0.0140845070422535,0,0.985915492957746,0.10126582278481,0,0,0,0,1
"25019950200",2017,88,0,0,11,21,56,81,0,0,11,19,51,7,0,0,0,2,5,0,0,0.125,0.238636363636364,0.636363636363636,0.920454545454545,0,0,0.135802469135802,0.234567901234568,0.62962962962963,0.0795454545454545,0,0,0,0.285714285714286,0.714285714285714
"25019950307",2017,15,0,0,0,3,12,13,0,0,0,3,10,2,0,0,0,0,2,0,0,0,0.2,0.8,0.866666666666667,0,0,0,0.230769230769231,0.769230769230769,0.133333333333333,0,0,0,0,1
"25019950400",2017,54,0,0,3,15,36,48,0,0,2,15,31,6,0,0,1,0,5,0,0,0.0555555555555556,0.277777777777778,0.666666666666667,0.888888888888889,0,0,0.0416666666666667,0.3125,0.645833333333333,0.111111111111111,0,0,0.166666666666667,0,0.833333333333333
"25019950500",2017,47,0,0,1,3,43,46,0,0,1,3,42,1,0,0,0,0,1,0,0,0.0212765957446809,0.0638297872340425,0.914893617021277,0.978723404255319,0,0,0.0217391304347826,0.0652173913043478,0.91304347826087,0.0212765957446809,0,0,0,0,1
"25021400100",2017,36,0,0,2,3,31,34,0,0,2,3,29,2,0,0,0,0,2,0,0,0.0555555555555556,0.0833333333333333,0.861111111111111,0.944444444444444,0,0,0.0588235294117647,0.0882352941176471,0.852941176470588,0.0555555555555556,0,0,0,0,1
"25021400200",2017,46,0,0,3,9,34,45,0,0,3,9,33,1,0,0,0,0,1,0,0,0.0652173913043478,0.195652173913043,0.739130434782609,0.978260869565217,0,0,0.0666666666666667,0.2,0.733333333333333,0.0217391304347826,0,0,0,0,1
"25021400300",2017,35,0,0,0,3,32,34,0,0,0,3,31,1,0,0,0,0,1,0,0,0,0.0857142857142857,0.914285714285714,0.971428571428571,0,0,0,0.0882352941176471,0.911764705882353,0.0285714285714286,0,0,0,0,1
"25021400400",2017,51,0,0,5,8,38,46,0,0,5,6,35,5,0,0,0,2,3,0,0,0.0980392156862745,0.156862745098039,0.745098039215686,0.901960784313726,0,0,0.108695652173913,0.130434782608696,0.760869565217391,0.0980392156862745,0,0,0,0.4,0.6
"25021400500",2017,37,0,0,0,2,35,37,0,0,0,2,35,0,0,0,0,0,0,0,0,0,0.0540540540540541,0.945945945945946,1,0,0,0,0.0540540540540541,0.945945945945946,0,0,0,0,0,0
"25021400600",2017,63,0,0,0,12,51,60,0,0,0,12,48,3,0,0,0,0,3,0,0,0,0.19047619047619,0.80952380952381,0.952380952380952,0,0,0,0.2,0.8,0.0476190476190476,0,0,0,0,1
"25021400700",2017,50,0,0,1,1,48,47,0,0,1,1,45,3,0,0,0,0,3,0,0,0.02,0.02,0.96,0.94,0,0,0.0212765957446809,0.0212765957446809,0.957446808510638,0.06,0,0,0,0,1
"25021400800",2017,34,0,0,0,9,25,31,0,0,0,8,23,3,0,0,0,1,2,0,0,0,0.264705882352941,0.735294117647059,0.911764705882353,0,0,0,0.258064516129032,0.741935483870968,0.0882352941176471,0,0,0,0.333333333333333,0.666666666666667
"25021400900",2017,46,0,0,1,6,39,41,0,0,0,6,35,5,0,0,1,0,4,0,0,0.0217391304347826,0.130434782608696,0.847826086956522,0.891304347826087,0,0,0,0.146341463414634,0.853658536585366,0.108695652173913,0,0,0.2,0,0.8
"25021401000",2017,33,0,0,0,8,25,30,0,0,0,8,22,3,0,0,0,0,3,0,0,0,0.242424242424242,0.757575757575758,0.909090909090909,0,0,0,0.266666666666667,0.733333333333333,0.0909090909090909,0,0,0,0,1
"25021401100",2017,58,0,0,2,5,51,55,0,0,1,5,49,3,0,0,1,0,2,0,0,0.0344827586206897,0.0862068965517241,0.879310344827586,0.948275862068966,0,0,0.0181818181818182,0.0909090909090909,0.890909090909091,0.0517241379310345,0,0,0.333333333333333,0,0.666666666666667
"25021401200",2017,62,0,0,0,4,58,57,0,0,0,3,54,5,0,0,0,1,4,0,0,0,0.0645161290322581,0.935483870967742,0.919354838709677,0,0,0,0.0526315789473684,0.947368421052632,0.0806451612903226,0,0,0,0.2,0.8
"25021402101",2017,47,0,2,10,19,16,43,0,0,9,18,16,4,0,2,1,1,0,0,0.0425531914893617,0.212765957446809,0.404255319148936,0.340425531914894,0.914893617021277,0,0,0.209302325581395,0.418604651162791,0.372093023255814,0.0851063829787234,0,0.5,0.25,0.25,0
"25021402102",2017,65,0,0,13,32,20,61,0,0,12,31,18,4,0,0,1,1,2,0,0,0.2,0.492307692307692,0.307692307692308,0.938461538461538,0,0,0.19672131147541,0.508196721311475,0.295081967213115,0.0615384615384615,0,0,0.25,0.25,0.5
"25021402200",2017,25,0,0,3,11,11,24,0,0,2,11,11,1,0,0,1,0,0,0,0,0.12,0.44,0.44,0.96,0,0,0.0833333333333333,0.458333333333333,0.458333333333333,0.04,0,0,1,0,0
"25021402300",2017,84,0,0,7,30,47,79,0,0,7,27,45,5,0,0,0,3,2,0,0,0.0833333333333333,0.357142857142857,0.55952380952381,0.94047619047619,0,0,0.0886075949367089,0.341772151898734,0.569620253164557,0.0595238095238095,0,0,0,0.6,0.4
"25021402400",2017,68,0,0,7,22,39,64,0,0,7,19,38,4,0,0,0,3,1,0,0,0.102941176470588,0.323529411764706,0.573529411764706,0.941176470588235,0,0,0.109375,0.296875,0.59375,0.0588235294117647,0,0,0,0.75,0.25
"25021402500",2017,54,0,0,1,12,41,52,0,0,1,12,39,2,0,0,0,0,2,0,0,0.0185185185185185,0.222222222222222,0.759259259259259,0.962962962962963,0,0,0.0192307692307692,0.230769230769231,0.75,0.037037037037037,0,0,0,0,1
"25021403100",2017,131,0,0,2,9,120,126,0,0,2,7,117,5,0,0,0,2,3,0,0,0.0152671755725191,0.0687022900763359,0.916030534351145,0.961832061068702,0,0,0.0158730158730159,0.0555555555555556,0.928571428571429,0.0381679389312977,0,0,0,0.4,0.6
"25021403300",2017,52,0,0,0,6,46,49,0,0,0,5,44,3,0,0,0,1,2,0,0,0,0.115384615384615,0.884615384615385,0.942307692307692,0,0,0,0.102040816326531,0.897959183673469,0.0576923076923077,0,0,0,0.333333333333333,0.666666666666667
"25021403400",2017,79,0,0,0,6,73,76,0,0,0,5,71,3,0,0,0,1,2,0,0,0,0.0759493670886076,0.924050632911392,0.962025316455696,0,0,0,0.0657894736842105,0.934210526315789,0.0379746835443038,0,0,0,0.333333333333333,0.666666666666667
"25021403500",2017,75,0,0,1,14,60,71,0,0,1,13,57,4,0,0,0,1,3,0,0,0.0133333333333333,0.186666666666667,0.8,0.946666666666667,0,0,0.0140845070422535,0.183098591549296,0.802816901408451,0.0533333333333333,0,0,0,0.25,0.75
"25021404100",2017,63,0,0,1,0,62,60,0,0,1,0,59,3,0,0,0,0,3,0,0,0.0158730158730159,0,0.984126984126984,0.952380952380952,0,0,0.0166666666666667,0,0.983333333333333,0.0476190476190476,0,0,0,0,1
"25021404201",2017,60,0,0,2,3,55,57,0,0,1,3,53,3,0,0,1,0,2,0,0,0.0333333333333333,0.05,0.916666666666667,0.95,0,0,0.0175438596491228,0.0526315789473684,0.929824561403509,0.05,0,0,0.333333333333333,0,0.666666666666667
"25021404202",2017,43,1,0,0,5,37,39,0,0,0,4,35,4,1,0,0,1,2,0.0232558139534884,0,0,0.116279069767442,0.86046511627907,0.906976744186046,0,0,0,0.102564102564103,0.897435897435897,0.0930232558139535,0.25,0,0,0.25,0.5
"25021404301",2017,90,0,0,0,3,87,86,0,0,0,3,83,4,0,0,0,0,4,0,0,0,0.0333333333333333,0.966666666666667,0.955555555555556,0,0,0,0.0348837209302326,0.965116279069767,0.0444444444444444,0,0,0,0,1
"25021404302",2017,52,0,0,2,7,43,46,0,0,1,5,40,6,0,0,1,2,3,0,0,0.0384615384615385,0.134615384615385,0.826923076923077,0.884615384615385,0,0,0.0217391304347826,0.108695652173913,0.869565217391304,0.115384615384615,0,0,0.166666666666667,0.333333333333333,0.5
"25021404400",2017,53,0,0,0,3,50,47,0,0,0,2,45,6,0,0,0,1,5,0,0,0,0.0566037735849057,0.943396226415094,0.886792452830189,0,0,0,0.0425531914893617,0.957446808510638,0.113207547169811,0,0,0,0.166666666666667,0.833333333333333
"25021405100",2017,130,0,0,4,5,121,120,0,0,4,5,111,10,0,0,0,0,10,0,0,0.0307692307692308,0.0384615384615385,0.930769230769231,0.923076923076923,0,0,0.0333333333333333,0.0416666666666667,0.925,0.0769230769230769,0,0,0,0,1
"25021406101",2017,88,0,0,2,12,74,83,0,0,2,11,70,5,0,0,0,1,4,0,0,0.0227272727272727,0.136363636363636,0.840909090909091,0.943181818181818,0,0,0.0240963855421687,0.132530120481928,0.843373493975904,0.0568181818181818,0,0,0,0.2,0.8
"25021406102",2017,99,0,0,5,12,82,95,0,0,5,11,79,4,0,0,0,1,3,0,0,0.0505050505050505,0.121212121212121,0.828282828282828,0.95959595959596,0,0,0.0526315789473684,0.115789473684211,0.831578947368421,0.0404040404040404,0,0,0,0.25,0.75
"25021407100",2017,153,0,0,21,64,68,144,0,0,19,58,67,9,0,0,2,6,1,0,0,0.137254901960784,0.418300653594771,0.444444444444444,0.941176470588235,0,0,0.131944444444444,0.402777777777778,0.465277777777778,0.0588235294117647,0,0,0.222222222222222,0.666666666666667,0.111111111111111
"25021408101",2017,115,0,0,18,36,61,112,0,0,18,35,59,3,0,0,0,1,2,0,0,0.156521739130435,0.31304347826087,0.530434782608696,0.973913043478261,0,0,0.160714285714286,0.3125,0.526785714285714,0.0260869565217391,0,0,0,0.333333333333333,0.666666666666667
"25021408102",2017,68,0,0,13,34,21,64,0,0,13,30,21,4,0,0,0,4,0,0,0,0.191176470588235,0.5,0.308823529411765,0.941176470588235,0,0,0.203125,0.46875,0.328125,0.0588235294117647,0,0,0,1,0
"25021409101",2017,83,0,0,7,17,59,74,0,0,5,15,54,9,0,0,2,2,5,0,0,0.0843373493975904,0.204819277108434,0.710843373493976,0.891566265060241,0,0,0.0675675675675676,0.202702702702703,0.72972972972973,0.108433734939759,0,0,0.222222222222222,0.222222222222222,0.555555555555556
"25021409102",2017,108,0,0,5,28,75,102,0,0,5,26,71,6,0,0,0,2,4,0,0,0.0462962962962963,0.259259259259259,0.694444444444444,0.944444444444444,0,0,0.0490196078431373,0.254901960784314,0.696078431372549,0.0555555555555556,0,0,0,0.333333333333333,0.666666666666667
"25021410100",2017,96,0,1,15,30,50,93,0,1,13,30,49,3,0,0,2,0,1,0,0.0104166666666667,0.15625,0.3125,0.520833333333333,0.96875,0,0.010752688172043,0.139784946236559,0.32258064516129,0.526881720430108,0.03125,0,0,0.666666666666667,0,0.333333333333333
"25021410300",2017,53,0,0,9,26,18,52,0,0,9,25,18,1,0,0,0,1,0,0,0,0.169811320754717,0.490566037735849,0.339622641509434,0.981132075471698,0,0,0.173076923076923,0.480769230769231,0.346153846153846,0.0188679245283019,0,0,0,1,0
"25021410400",2017,86,0,0,18,35,33,81,0,0,16,32,33,5,0,0,2,3,0,0,0,0.209302325581395,0.406976744186047,0.383720930232558,0.941860465116279,0,0,0.197530864197531,0.395061728395062,0.407407407407407,0.0581395348837209,0,0,0.4,0.6,0
"25021411100",2017,99,0,2,16,32,49,90,0,1,13,30,46,9,0,1,3,2,3,0,0.0202020202020202,0.161616161616162,0.323232323232323,0.494949494949495,0.909090909090909,0,0.0111111111111111,0.144444444444444,0.333333333333333,0.511111111111111,0.0909090909090909,0,0.111111111111111,0.333333333333333,0.222222222222222,0.333333333333333
"25021411200",2017,101,0,0,11,34,56,95,0,0,11,31,53,6,0,0,0,3,3,0,0,0.108910891089109,0.336633663366337,0.554455445544555,0.940594059405941,0,0,0.115789473684211,0.326315789473684,0.557894736842105,0.0594059405940594,0,0,0,0.5,0.5
"25021411301",2017,99,0,0,13,14,72,92,0,0,11,12,69,7,0,0,2,2,3,0,0,0.131313131313131,0.141414141414141,0.727272727272727,0.929292929292929,0,0,0.119565217391304,0.130434782608696,0.75,0.0707070707070707,0,0,0.285714285714286,0.285714285714286,0.428571428571429
"25021411302",2017,65,0,1,6,24,34,63,0,1,6,22,34,2,0,0,0,2,0,0,0.0153846153846154,0.0923076923076923,0.369230769230769,0.523076923076923,0.969230769230769,0,0.0158730158730159,0.0952380952380952,0.349206349206349,0.53968253968254,0.0307692307692308,0,0,0,1,0
"25021412100",2017,104,0,0,1,21,82,104,0,0,1,21,82,0,0,0,0,0,0,0,0,0.00961538461538462,0.201923076923077,0.788461538461538,1,0,0,0.00961538461538462,0.201923076923077,0.788461538461538,0,0,0,0,0,0
"25021412200",2017,51,0,0,0,2,49,49,0,0,0,1,48,2,0,0,0,1,1,0,0,0,0.0392156862745098,0.96078431372549,0.96078431372549,0,0,0,0.0204081632653061,0.979591836734694,0.0392156862745098,0,0,0,0.5,0.5
"25021412300",2017,46,0,0,1,9,36,44,0,0,0,9,35,2,0,0,1,0,1,0,0,0.0217391304347826,0.195652173913043,0.782608695652174,0.956521739130435,0,0,0,0.204545454545455,0.795454545454545,0.0434782608695652,0,0,0.5,0,0.5
"25021413100",2017,66,0,1,8,30,27,64,0,0,8,29,27,2,0,1,0,1,0,0,0.0151515151515152,0.121212121212121,0.454545454545455,0.409090909090909,0.96969696969697,0,0,0.125,0.453125,0.421875,0.0303030303030303,0,0.5,0,0.5,0
"25021413200",2017,79,0,0,12,34,33,74,0,0,12,32,30,5,0,0,0,2,3,0,0,0.151898734177215,0.430379746835443,0.417721518987342,0.936708860759494,0,0,0.162162162162162,0.432432432432432,0.405405405405405,0.0632911392405063,0,0,0,0.4,0.6
"25021413300",2017,47,0,2,5,14,26,45,0,2,4,14,25,2,0,0,1,0,1,0,0.0425531914893617,0.106382978723404,0.297872340425532,0.553191489361702,0.957446808510638,0,0.0444444444444444,0.0888888888888889,0.311111111111111,0.555555555555556,0.0425531914893617,0,0,0.5,0,0.5
"25021413401",2017,25,0,0,7,10,8,25,0,0,7,10,8,0,0,0,0,0,0,0,0,0.28,0.4,0.32,1,0,0,0.28,0.4,0.32,0,0,0,0,0,0
"25021413402",2017,59,0,0,9,33,17,59,0,0,9,33,17,0,0,0,0,0,0,0,0,0.152542372881356,0.559322033898305,0.288135593220339,1,0,0,0.152542372881356,0.559322033898305,0.288135593220339,0,0,0,0,0,0
"25021413500",2017,44,0,0,14,18,12,35,0,0,12,12,11,9,0,0,2,6,1,0,0,0.318181818181818,0.409090909090909,0.272727272727273,0.795454545454545,0,0,0.342857142857143,0.342857142857143,0.314285714285714,0.204545454545455,0,0,0.222222222222222,0.666666666666667,0.111111111111111
"25021414100",2017,78,0,0,5,24,49,74,0,0,5,24,45,4,0,0,0,0,4,0,0,0.0641025641025641,0.307692307692308,0.628205128205128,0.948717948717949,0,0,0.0675675675675676,0.324324324324324,0.608108108108108,0.0512820512820513,0,0,0,0,1
"25021414200",2017,107,0,0,4,36,67,103,0,0,4,34,65,4,0,0,0,2,2,0,0,0.0373831775700935,0.336448598130841,0.626168224299065,0.962616822429907,0,0,0.0388349514563107,0.330097087378641,0.631067961165049,0.0373831775700935,0,0,0,0.5,0.5
"25021414300",2017,75,0,0,8,22,45,70,0,0,8,20,42,5,0,0,0,2,3,0,0,0.106666666666667,0.293333333333333,0.6,0.933333333333333,0,0,0.114285714285714,0.285714285714286,0.6,0.0666666666666667,0,0,0,0.4,0.6
"25021415101",2017,68,0,0,10,21,37,62,0,0,7,20,35,6,0,0,3,1,2,0,0,0.147058823529412,0.308823529411765,0.544117647058823,0.911764705882353,0,0,0.112903225806452,0.32258064516129,0.564516129032258,0.0882352941176471,0,0,0.5,0.166666666666667,0.333333333333333
"25021415102",2017,124,0,2,29,45,48,115,0,2,25,44,44,9,0,0,4,1,4,0,0.0161290322580645,0.233870967741935,0.362903225806452,0.387096774193548,0.92741935483871,0,0.0173913043478261,0.217391304347826,0.382608695652174,0.382608695652174,0.0725806451612903,0,0,0.444444444444444,0.111111111111111,0.444444444444444
"25021415200",2017,96,0,0,12,24,60,90,0,0,10,22,58,6,0,0,2,2,2,0,0,0.125,0.25,0.625,0.9375,0,0,0.111111111111111,0.244444444444444,0.644444444444444,0.0625,0,0,0.333333333333333,0.333333333333333,0.333333333333333
"25021415300",2017,74,1,0,7,10,56,66,0,0,5,9,52,8,1,0,2,1,4,0.0135135135135135,0,0.0945945945945946,0.135135135135135,0.756756756756757,0.891891891891892,0,0,0.0757575757575758,0.136363636363636,0.787878787878788,0.108108108108108,0.125,0,0.25,0.125,0.5
"25021416101",2017,91,0,0,1,16,74,87,0,0,1,15,71,4,0,0,0,1,3,0,0,0.010989010989011,0.175824175824176,0.813186813186813,0.956043956043956,0,0,0.0114942528735632,0.172413793103448,0.816091954022989,0.043956043956044,0,0,0,0.25,0.75
"25021416102",2017,40,0,1,5,1,33,35,0,1,4,0,30,5,0,0,1,1,3,0,0.025,0.125,0.025,0.825,0.875,0,0.0285714285714286,0.114285714285714,0,0.857142857142857,0.125,0,0,0.2,0.2,0.6
"25021416200",2017,88,0,1,7,27,53,85,0,1,7,25,52,3,0,0,0,2,1,0,0.0113636363636364,0.0795454545454545,0.306818181818182,0.602272727272727,0.965909090909091,0,0.0117647058823529,0.0823529411764706,0.294117647058824,0.611764705882353,0.0340909090909091,0,0,0,0.666666666666667,0.333333333333333
"25021416300",2017,64,0,1,1,15,47,62,0,1,1,14,46,2,0,0,0,1,1,0,0.015625,0.015625,0.234375,0.734375,0.96875,0,0.0161290322580645,0.0161290322580645,0.225806451612903,0.741935483870968,0.03125,0,0,0,0.5,0.5
"25021416400",2017,92,0,0,4,22,66,90,0,0,4,20,66,2,0,0,0,2,0,0,0,0.0434782608695652,0.239130434782609,0.717391304347826,0.978260869565217,0,0,0.0444444444444444,0.222222222222222,0.733333333333333,0.0217391304347826,0,0,0,1,0
"25021417100",2017,64,1,2,21,18,22,62,1,2,19,18,22,2,0,0,2,0,0,0.015625,0.03125,0.328125,0.28125,0.34375,0.96875,0.0161290322580645,0.032258064516129,0.306451612903226,0.290322580645161,0.354838709677419,0.03125,0,0,1,0,0
"25021417200",2017,66,0,1,25,25,15,60,0,1,22,24,13,6,0,0,3,1,2,0,0.0151515151515152,0.378787878787879,0.378787878787879,0.227272727272727,0.909090909090909,0,0.0166666666666667,0.366666666666667,0.4,0.216666666666667,0.0909090909090909,0,0,0.5,0.166666666666667,0.333333333333333
"25021417300",2017,60,0,0,9,25,26,54,0,0,9,23,22,6,0,0,0,2,4,0,0,0.15,0.416666666666667,0.433333333333333,0.9,0,0,0.166666666666667,0.425925925925926,0.407407407407407,0.1,0,0,0,0.333333333333333,0.666666666666667
"25021417400",2017,42,0,0,2,9,31,38,0,0,2,9,27,4,0,0,0,0,4,0,0,0.0476190476190476,0.214285714285714,0.738095238095238,0.904761904761905,0,0,0.0526315789473684,0.236842105263158,0.710526315789474,0.0952380952380952,0,0,0,0,1
"25021417501",2017,62,0,3,19,25,15,51,0,2,17,19,13,11,0,1,2,6,2,0,0.0483870967741935,0.306451612903226,0.403225806451613,0.241935483870968,0.82258064516129,0,0.0392156862745098,0.333333333333333,0.372549019607843,0.254901960784314,0.17741935483871,0,0.0909090909090909,0.181818181818182,0.545454545454545,0.181818181818182
"25021417502",2017,67,0,3,23,24,17,60,0,2,19,22,17,7,0,1,4,2,0,0,0.0447761194029851,0.343283582089552,0.358208955223881,0.253731343283582,0.895522388059702,0,0.0333333333333333,0.316666666666667,0.366666666666667,0.283333333333333,0.104477611940299,0,0.142857142857143,0.571428571428571,0.285714285714286,0
"25021417601",2017,55,0,2,14,24,15,50,0,2,13,21,14,5,0,0,1,3,1,0,0.0363636363636364,0.254545454545455,0.436363636363636,0.272727272727273,0.909090909090909,0,0.04,0.26,0.42,0.28,0.0909090909090909,0,0,0.2,0.6,0.2
"25021417602",2017,51,0,1,14,21,15,51,0,1,14,21,15,0,0,0,0,0,0,0,0.0196078431372549,0.274509803921569,0.411764705882353,0.294117647058824,1,0,0.0196078431372549,0.274509803921569,0.411764705882353,0.294117647058824,0,0,0,0,0,0
"25021417701",2017,145,0,1,34,64,46,129,0,1,26,58,44,16,0,0,8,6,2,0,0.00689655172413793,0.23448275862069,0.441379310344828,0.317241379310345,0.889655172413793,0,0.00775193798449612,0.201550387596899,0.449612403100775,0.341085271317829,0.110344827586207,0,0,0.5,0.375,0.125
"25021417702",2017,40,0,0,3,17,20,38,0,0,3,15,20,2,0,0,0,2,0,0,0,0.075,0.425,0.5,0.95,0,0,0.0789473684210526,0.394736842105263,0.526315789473684,0.05,0,0,0,1,0
"25021417801",2017,78,0,0,30,30,18,75,0,0,28,29,18,3,0,0,2,1,0,0,0,0.384615384615385,0.384615384615385,0.230769230769231,0.961538461538462,0,0,0.373333333333333,0.386666666666667,0.24,0.0384615384615385,0,0,0.666666666666667,0.333333333333333,0
"25021417802",2017,22,0,1,6,8,7,16,0,1,5,6,4,6,0,0,1,2,3,0,0.0454545454545455,0.272727272727273,0.363636363636364,0.318181818181818,0.727272727272727,0,0.0625,0.3125,0.375,0.25,0.272727272727273,0,0,0.166666666666667,0.333333333333333,0.5
"25021417901",2017,67,0,3,23,22,19,55,0,1,18,21,15,12,0,2,5,1,4,0,0.0447761194029851,0.343283582089552,0.328358208955224,0.283582089552239,0.82089552238806,0,0.0181818181818182,0.327272727272727,0.381818181818182,0.272727272727273,0.17910447761194,0,0.166666666666667,0.416666666666667,0.0833333333333333,0.333333333333333
"25021417902",2017,45,0,2,15,13,15,44,0,1,15,13,15,1,0,1,0,0,0,0,0.0444444444444444,0.333333333333333,0.288888888888889,0.333333333333333,0.977777777777778,0,0.0227272727272727,0.340909090909091,0.295454545454545,0.340909090909091,0.0222222222222222,0,1,0,0,0
"25021418002",2017,69,0,2,21,27,19,61,0,2,17,25,17,8,0,0,4,2,2,0,0.0289855072463768,0.304347826086957,0.391304347826087,0.27536231884058,0.884057971014493,0,0.0327868852459016,0.278688524590164,0.409836065573771,0.278688524590164,0.115942028985507,0,0,0.5,0.25,0.25
"25021418003",2017,37,0,0,9,19,9,33,0,0,8,16,9,4,0,0,1,3,0,0,0,0.243243243243243,0.513513513513513,0.243243243243243,0.891891891891892,0,0,0.242424242424242,0.484848484848485,0.272727272727273,0.108108108108108,0,0,0.25,0.75,0
"25021418004",2017,58,0,1,20,25,12,47,0,1,13,22,11,11,0,0,7,3,1,0,0.0172413793103448,0.344827586206897,0.431034482758621,0.206896551724138,0.810344827586207,0,0.0212765957446809,0.276595744680851,0.468085106382979,0.234042553191489,0.189655172413793,0,0,0.636363636363636,0.272727272727273,0.0909090909090909
"25021418101",2017,49,0,0,12,17,20,45,0,0,12,13,20,4,0,0,0,4,0,0,0,0.244897959183673,0.346938775510204,0.408163265306122,0.918367346938776,0,0,0.266666666666667,0.288888888888889,0.444444444444444,0.0816326530612245,0,0,0,1,0
"25021418102",2017,43,0,1,10,19,13,39,0,1,8,18,12,4,0,0,2,1,1,0,0.0232558139534884,0.232558139534884,0.441860465116279,0.302325581395349,0.906976744186046,0,0.0256410256410256,0.205128205128205,0.461538461538462,0.307692307692308,0.0930232558139535,0,0,0.5,0.25,0.25
"25021418200",2017,82,0,1,20,40,21,72,0,1,18,35,18,10,0,0,2,5,3,0,0.0121951219512195,0.24390243902439,0.48780487804878,0.25609756097561,0.878048780487805,0,0.0138888888888889,0.25,0.486111111111111,0.25,0.121951219512195,0,0,0.2,0.5,0.3
"25021419100",2017,66,2,1,10,22,31,61,2,1,9,19,30,5,0,0,1,3,1,0.0303030303030303,0.0151515151515152,0.151515151515152,0.333333333333333,0.46969696969697,0.924242424242424,0.0327868852459016,0.0163934426229508,0.147540983606557,0.311475409836066,0.491803278688525,0.0757575757575758,0,0,0.2,0.6,0.2
"25021419200",2017,57,0,0,17,19,21,53,0,0,15,18,20,4,0,0,2,1,1,0,0,0.298245614035088,0.333333333333333,0.368421052631579,0.929824561403509,0,0,0.283018867924528,0.339622641509434,0.377358490566038,0.0701754385964912,0,0,0.5,0.25,0.25
"25021419300",2017,45,0,2,12,14,17,43,0,2,10,14,17,2,0,0,2,0,0,0,0.0444444444444444,0.266666666666667,0.311111111111111,0.377777777777778,0.955555555555556,0,0.0465116279069767,0.232558139534884,0.325581395348837,0.395348837209302,0.0444444444444444,0,0,1,0,0
"25021419400",2017,36,0,2,7,18,9,33,0,2,6,17,8,3,0,0,1,1,1,0,0.0555555555555556,0.194444444444444,0.5,0.25,0.916666666666667,0,0.0606060606060606,0.181818181818182,0.515151515151515,0.242424242424242,0.0833333333333333,0,0,0.333333333333333,0.333333333333333,0.333333333333333
"25021419500",2017,46,0,0,7,17,22,46,0,0,7,17,22,0,0,0,0,0,0,0,0,0.152173913043478,0.369565217391304,0.478260869565217,1,0,0,0.152173913043478,0.369565217391304,0.478260869565217,0,0,0,0,0,0
"25021419600",2017,111,1,0,23,37,50,100,1,0,21,34,44,11,0,0,2,3,6,0.00900900900900901,0,0.207207207207207,0.333333333333333,0.45045045045045,0.900900900900901,0.01,0,0.21,0.34,0.44,0.0990990990990991,0,0,0.181818181818182,0.272727272727273,0.545454545454545
"25021419700",2017,68,0,2,12,24,30,60,0,1,11,22,26,8,0,1,1,2,4,0,0.0294117647058824,0.176470588235294,0.352941176470588,0.441176470588235,0.882352941176471,0,0.0166666666666667,0.183333333333333,0.366666666666667,0.433333333333333,0.117647058823529,0,0.125,0.125,0.25,0.5
"25021419800",2017,52,1,0,15,23,13,41,1,0,11,18,11,11,0,0,4,5,2,0.0192307692307692,0,0.288461538461538,0.442307692307692,0.25,0.788461538461538,0.024390243902439,0,0.268292682926829,0.439024390243902,0.268292682926829,0.211538461538462,0,0,0.363636363636364,0.454545454545455,0.181818181818182
"25021420100",2017,129,0,2,48,61,18,117,0,2,45,54,16,12,0,0,3,7,2,0,0.0155038759689922,0.372093023255814,0.472868217054264,0.13953488372093,0.906976744186046,0,0.0170940170940171,0.384615384615385,0.461538461538462,0.136752136752137,0.0930232558139535,0,0,0.25,0.583333333333333,0.166666666666667
"25021420201",2017,49,0,1,23,20,5,41,0,0,19,18,4,8,0,1,4,2,1,0,0.0204081632653061,0.469387755102041,0.408163265306122,0.102040816326531,0.836734693877551,0,0,0.463414634146341,0.439024390243902,0.0975609756097561,0.163265306122449,0,0.125,0.5,0.25,0.125
"25021420202",2017,79,0,4,30,29,16,68,0,3,26,25,14,11,0,1,4,4,2,0,0.0506329113924051,0.379746835443038,0.367088607594937,0.20253164556962,0.860759493670886,0,0.0441176470588235,0.382352941176471,0.367647058823529,0.205882352941176,0.139240506329114,0,0.0909090909090909,0.363636363636364,0.363636363636364,0.181818181818182
"25021420301",2017,116,0,2,48,53,13,100,0,2,40,46,12,16,0,0,8,7,1,0,0.0172413793103448,0.413793103448276,0.456896551724138,0.112068965517241,0.862068965517241,0,0.02,0.4,0.46,0.12,0.137931034482759,0,0,0.5,0.4375,0.0625
"25021420302",2017,105,1,2,32,57,13,93,0,2,29,53,9,12,1,0,3,4,4,0.00952380952380952,0.019047619047619,0.304761904761905,0.542857142857143,0.123809523809524,0.885714285714286,0,0.021505376344086,0.311827956989247,0.56989247311828,0.0967741935483871,0.114285714285714,0.0833333333333333,0,0.25,0.333333333333333,0.333333333333333
"25021421100",2017,79,0,0,37,36,6,71,0,0,31,34,6,8,0,0,6,2,0,0,0,0.468354430379747,0.455696202531646,0.0759493670886076,0.89873417721519,0,0,0.436619718309859,0.47887323943662,0.0845070422535211,0.10126582278481,0,0,0.75,0.25,0
"25021421200",2017,123,0,2,50,58,13,102,0,1,39,50,12,21,0,1,11,8,1,0,0.016260162601626,0.40650406504065,0.471544715447154,0.105691056910569,0.829268292682927,0,0.00980392156862745,0.382352941176471,0.490196078431373,0.117647058823529,0.170731707317073,0,0.0476190476190476,0.523809523809524,0.380952380952381,0.0476190476190476
"25021422100",2017,72,0,0,15,26,31,70,0,0,15,24,31,2,0,0,0,2,0,0,0,0.208333333333333,0.361111111111111,0.430555555555556,0.972222222222222,0,0,0.214285714285714,0.342857142857143,0.442857142857143,0.0277777777777778,0,0,0,1,0
"25021422200",2017,189,0,5,39,64,81,168,0,2,33,58,75,21,0,3,6,6,6,0,0.0264550264550265,0.206349206349206,0.338624338624339,0.428571428571429,0.888888888888889,0,0.0119047619047619,0.196428571428571,0.345238095238095,0.446428571428571,0.111111111111111,0,0.142857142857143,0.285714285714286,0.285714285714286,0.285714285714286
"25021422301",2017,55,1,1,16,20,17,52,0,1,15,20,16,3,1,0,1,0,1,0.0181818181818182,0.0181818181818182,0.290909090909091,0.363636363636364,0.309090909090909,0.945454545454545,0,0.0192307692307692,0.288461538461538,0.384615384615385,0.307692307692308,0.0545454545454545,0.333333333333333,0,0.333333333333333,0,0.333333333333333
"25021422302",2017,100,0,1,42,39,18,91,0,1,38,34,18,9,0,0,4,5,0,0,0.01,0.42,0.39,0.18,0.91,0,0.010989010989011,0.417582417582418,0.373626373626374,0.197802197802198,0.09,0,0,0.444444444444444,0.555555555555556,0
"25021422400",2017,114,2,6,35,42,29,97,0,2,31,36,28,17,2,4,4,6,1,0.0175438596491228,0.0526315789473684,0.307017543859649,0.368421052631579,0.254385964912281,0.850877192982456,0,0.0206185567010309,0.319587628865979,0.371134020618557,0.288659793814433,0.149122807017544,0.117647058823529,0.235294117647059,0.235294117647059,0.352941176470588,0.0588235294117647
"25021422501",2017,66,0,0,31,21,14,63,0,0,30,20,13,3,0,0,1,1,1,0,0,0.46969696969697,0.318181818181818,0.212121212121212,0.954545454545455,0,0,0.476190476190476,0.317460317460317,0.206349206349206,0.0454545454545455,0,0,0.333333333333333,0.333333333333333,0.333333333333333
"25021422502",2017,59,0,1,29,22,7,54,0,1,26,20,7,5,0,0,3,2,0,0,0.0169491525423729,0.491525423728814,0.372881355932203,0.11864406779661,0.915254237288136,0,0.0185185185185185,0.481481481481481,0.37037037037037,0.12962962962963,0.0847457627118644,0,0,0.6,0.4,0
"25021422600",2017,132,0,2,35,45,50,121,0,2,29,44,46,11,0,0,6,1,4,0,0.0151515151515152,0.265151515151515,0.340909090909091,0.378787878787879,0.916666666666667,0,0.0165289256198347,0.239669421487603,0.363636363636364,0.380165289256198,0.0833333333333333,0,0,0.545454545454545,0.0909090909090909,0.363636363636364
"25021422700",2017,73,0,1,26,30,16,67,0,0,23,28,16,6,0,1,3,2,0,0,0.0136986301369863,0.356164383561644,0.410958904109589,0.219178082191781,0.917808219178082,0,0,0.343283582089552,0.417910447761194,0.238805970149254,0.0821917808219178,0,0.166666666666667,0.5,0.333333333333333,0
"25021422800",2017,88,0,4,24,40,20,84,0,3,23,39,19,4,0,1,1,1,1,0,0.0454545454545455,0.272727272727273,0.454545454545455,0.227272727272727,0.954545454545455,0,0.0357142857142857,0.273809523809524,0.464285714285714,0.226190476190476,0.0454545454545455,0,0.25,0.25,0.25,0.25
"25021423100",2017,175,0,0,5,17,153,169,0,0,5,15,149,6,0,0,0,2,4,0,0,0.0285714285714286,0.0971428571428571,0.874285714285714,0.965714285714286,0,0,0.029585798816568,0.0887573964497041,0.881656804733728,0.0342857142857143,0,0,0,0.333333333333333,0.666666666666667
"25021440100",2017,169,0,1,43,61,64,158,0,1,39,57,61,11,0,0,4,4,3,0,0.00591715976331361,0.254437869822485,0.36094674556213,0.378698224852071,0.93491124260355,0,0.00632911392405063,0.246835443037975,0.360759493670886,0.386075949367089,0.0650887573964497,0,0,0.363636363636364,0.363636363636364,0.272727272727273
"25021441202",2017,42,0,0,2,12,28,39,0,0,1,11,27,3,0,0,1,1,1,0,0,0.0476190476190476,0.285714285714286,0.666666666666667,0.928571428571429,0,0,0.0256410256410256,0.282051282051282,0.692307692307692,0.0714285714285714,0,0,0.333333333333333,0.333333333333333,0.333333333333333
"25021441203",2017,69,0,0,18,20,31,62,0,0,15,18,29,7,0,0,3,2,2,0,0,0.260869565217391,0.289855072463768,0.449275362318841,0.898550724637681,0,0,0.241935483870968,0.290322580645161,0.467741935483871,0.101449275362319,0,0,0.428571428571429,0.285714285714286,0.285714285714286
"25021441204",2017,90,0,2,27,20,41,81,0,1,23,19,38,9,0,1,4,1,3,0,0.0222222222222222,0.3,0.222222222222222,0.455555555555556,0.9,0,0.0123456790123457,0.283950617283951,0.234567901234568,0.469135802469136,0.1,0,0.111111111111111,0.444444444444444,0.111111111111111,0.333333333333333
"25021442101",2017,71,0,0,9,39,23,68,0,0,8,37,23,3,0,0,1,2,0,0,0,0.126760563380282,0.549295774647887,0.323943661971831,0.957746478873239,0,0,0.117647058823529,0.544117647058823,0.338235294117647,0.0422535211267606,0,0,0.333333333333333,0.666666666666667,0
"25021442102",2017,163,0,5,39,63,56,151,0,3,35,61,52,12,0,2,4,2,4,0,0.0306748466257669,0.239263803680982,0.386503067484663,0.343558282208589,0.926380368098159,0,0.0198675496688742,0.231788079470199,0.403973509933775,0.344370860927152,0.0736196319018405,0,0.166666666666667,0.333333333333333,0.166666666666667,0.333333333333333
"25021442103",2017,109,0,0,12,34,63,104,0,0,10,33,61,5,0,0,2,1,2,0,0,0.110091743119266,0.311926605504587,0.577981651376147,0.954128440366973,0,0,0.0961538461538462,0.317307692307692,0.586538461538462,0.0458715596330275,0,0,0.4,0.2,0.4
"25021442201",2017,50,0,0,4,13,33,47,0,0,3,12,32,3,0,0,1,1,1,0,0,0.08,0.26,0.66,0.94,0,0,0.0638297872340425,0.25531914893617,0.680851063829787,0.06,0,0,0.333333333333333,0.333333333333333,0.333333333333333
"25021442202",2017,101,0,0,21,34,46,92,0,0,19,31,42,9,0,0,2,3,4,0,0,0.207920792079208,0.336633663366337,0.455445544554455,0.910891089108911,0,0,0.206521739130435,0.33695652173913,0.456521739130435,0.0891089108910891,0,0,0.222222222222222,0.333333333333333,0.444444444444444
"25021443101",2017,97,0,1,38,39,19,92,0,1,36,36,19,5,0,0,2,3,0,0,0.0103092783505155,0.391752577319588,0.402061855670103,0.195876288659794,0.948453608247423,0,0.0108695652173913,0.391304347826087,0.391304347826087,0.206521739130435,0.0515463917525773,0,0,0.4,0.6,0
"25021443102",2017,150,0,5,64,46,35,142,0,3,59,45,35,8,0,2,5,1,0,0,0.0333333333333333,0.426666666666667,0.306666666666667,0.233333333333333,0.946666666666667,0,0.0211267605633803,0.415492957746479,0.316901408450704,0.246478873239437,0.0533333333333333,0,0.25,0.625,0.125,0
"25021456101",2017,60,0,1,21,24,14,55,0,0,19,22,14,5,0,1,2,2,0,0,0.0166666666666667,0.35,0.4,0.233333333333333,0.916666666666667,0,0,0.345454545454545,0.4,0.254545454545455,0.0833333333333333,0,0.2,0.4,0.4,0
"25021456102",2017,57,0,0,17,32,8,56,0,0,17,32,7,1,0,0,0,0,1,0,0,0.298245614035088,0.56140350877193,0.140350877192982,0.982456140350877,0,0,0.303571428571429,0.571428571428571,0.125,0.0175438596491228,0,0,0,0,1
"25021456200",2017,34,0,0,14,15,5,31,0,0,11,15,5,3,0,0,3,0,0,0,0,0.411764705882353,0.441176470588235,0.147058823529412,0.911764705882353,0,0,0.354838709677419,0.483870967741935,0.161290322580645,0.0882352941176471,0,0,1,0,0
"25021456301",2017,23,0,1,14,6,2,15,0,0,8,5,2,8,0,1,6,1,0,0,0.0434782608695652,0.608695652173913,0.260869565217391,0.0869565217391304,0.652173913043478,0,0,0.533333333333333,0.333333333333333,0.133333333333333,0.347826086956522,0,0.125,0.75,0.125,0
"25021456302",2017,108,0,1,50,38,19,95,0,0,43,35,17,13,0,1,7,3,2,0,0.00925925925925926,0.462962962962963,0.351851851851852,0.175925925925926,0.87962962962963,0,0,0.452631578947368,0.368421052631579,0.178947368421053,0.12037037037037,0,0.0769230769230769,0.538461538461538,0.230769230769231,0.153846153846154
"25021456401",2017,49,0,2,18,20,9,40,0,0,14,18,8,9,0,2,4,2,1,0,0.0408163265306122,0.36734693877551,0.408163265306122,0.183673469387755,0.816326530612245,0,0,0.35,0.45,0.2,0.183673469387755,0,0.222222222222222,0.444444444444444,0.222222222222222,0.111111111111111
"25021456402",2017,90,0,1,14,41,34,79,0,0,12,35,32,11,0,1,2,6,2,0,0.0111111111111111,0.155555555555556,0.455555555555556,0.377777777777778,0.877777777777778,0,0,0.151898734177215,0.443037974683544,0.40506329113924,0.122222222222222,0,0.0909090909090909,0.181818181818182,0.545454545454545,0.181818181818182
"25021457100",2017,70,0,1,23,35,11,63,0,1,20,32,10,7,0,0,3,3,1,0,0.0142857142857143,0.328571428571429,0.5,0.157142857142857,0.9,0,0.0158730158730159,0.317460317460317,0.507936507936508,0.158730158730159,0.1,0,0,0.428571428571429,0.428571428571429,0.142857142857143
"25021457200",2017,69,0,1,1,3,64,65,0,1,1,3,60,4,0,0,0,0,4,0,0.0144927536231884,0.0144927536231884,0.0434782608695652,0.927536231884058,0.942028985507246,0,0.0153846153846154,0.0153846153846154,0.0461538461538462,0.923076923076923,0.0579710144927536,0,0,0,0,1
"25023500101",2017,63,0,0,6,20,37,57,0,0,6,17,34,6,0,0,0,3,3,0,0,0.0952380952380952,0.317460317460317,0.587301587301587,0.904761904761905,0,0,0.105263157894737,0.298245614035088,0.596491228070175,0.0952380952380952,0,0,0,0.5,0.5
"25023500103",2017,45,0,1,8,11,25,37,0,0,6,10,21,8,0,1,2,1,4,0,0.0222222222222222,0.177777777777778,0.244444444444444,0.555555555555556,0.822222222222222,0,0,0.162162162162162,0.27027027027027,0.567567567567568,0.177777777777778,0,0.125,0.25,0.125,0.5
"25023500104",2017,59,0,1,9,21,28,53,0,1,7,17,28,6,0,0,2,4,0,0,0.0169491525423729,0.152542372881356,0.355932203389831,0.474576271186441,0.898305084745763,0,0.0188679245283019,0.132075471698113,0.320754716981132,0.528301886792453,0.101694915254237,0,0,0.333333333333333,0.666666666666667,0
"25023501101",2017,62,0,0,0,7,55,53,0,0,0,6,47,9,0,0,0,1,8,0,0,0,0.112903225806452,0.887096774193548,0.854838709677419,0,0,0,0.113207547169811,0.886792452830189,0.145161290322581,0,0,0,0.111111111111111,0.888888888888889
"25023501102",2017,140,1,0,17,20,102,135,1,0,16,19,99,5,0,0,1,1,3,0.00714285714285714,0,0.121428571428571,0.142857142857143,0.728571428571429,0.964285714285714,0.00740740740740741,0,0.118518518518519,0.140740740740741,0.733333333333333,0.0357142857142857,0,0,0.2,0.2,0.6
"25023501201",2017,45,0,0,0,7,38,42,0,0,0,6,36,3,0,0,0,1,2,0,0,0,0.155555555555556,0.844444444444444,0.933333333333333,0,0,0,0.142857142857143,0.857142857142857,0.0666666666666667,0,0,0,0.333333333333333,0.666666666666667
"25023501202",2017,92,0,1,3,13,75,84,0,1,3,12,68,8,0,0,0,1,7,0,0.0108695652173913,0.0326086956521739,0.141304347826087,0.815217391304348,0.91304347826087,0,0.0119047619047619,0.0357142857142857,0.142857142857143,0.80952380952381,0.0869565217391304,0,0,0,0.125,0.875
"25023502101",2017,101,0,0,29,51,21,87,0,0,25,46,16,14,0,0,4,5,5,0,0,0.287128712871287,0.504950495049505,0.207920792079208,0.861386138613861,0,0,0.28735632183908,0.528735632183908,0.183908045977011,0.138613861386139,0,0,0.285714285714286,0.357142857142857,0.357142857142857
"25023502102",2017,95,2,1,30,41,21,89,0,0,29,40,20,6,2,1,1,1,1,0.0210526315789474,0.0105263157894737,0.315789473684211,0.431578947368421,0.221052631578947,0.936842105263158,0,0,0.325842696629214,0.449438202247191,0.224719101123595,0.0631578947368421,0.333333333333333,0.166666666666667,0.166666666666667,0.166666666666667,0.166666666666667
"25023502200",2017,98,0,1,42,40,15,84,0,0,31,39,14,14,0,1,11,1,1,0,0.0102040816326531,0.428571428571429,0.408163265306122,0.153061224489796,0.857142857142857,0,0,0.369047619047619,0.464285714285714,0.166666666666667,0.142857142857143,0,0.0714285714285714,0.785714285714286,0.0714285714285714,0.0714285714285714
"25023503101",2017,107,1,0,10,31,65,103,0,0,8,30,65,4,1,0,2,1,0,0.00934579439252336,0,0.0934579439252336,0.289719626168224,0.607476635514019,0.962616822429907,0,0,0.0776699029126214,0.29126213592233,0.631067961165049,0.0373831775700935,0.25,0,0.5,0.25,0
"25023503102",2017,125,0,0,17,43,65,115,0,0,15,39,61,10,0,0,2,4,4,0,0,0.136,0.344,0.52,0.92,0,0,0.130434782608696,0.339130434782609,0.530434782608696,0.08,0,0,0.2,0.4,0.4
"25023504101",2017,71,0,0,5,17,49,68,0,0,4,16,48,3,0,0,1,1,1,0,0,0.0704225352112676,0.23943661971831,0.690140845070423,0.957746478873239,0,0,0.0588235294117647,0.235294117647059,0.705882352941177,0.0422535211267606,0,0,0.333333333333333,0.333333333333333,0.333333333333333
"25023504102",2017,112,0,0,6,16,90,103,0,0,5,13,85,9,0,0,1,3,5,0,0,0.0535714285714286,0.142857142857143,0.803571428571429,0.919642857142857,0,0,0.0485436893203883,0.12621359223301,0.825242718446602,0.0803571428571429,0,0,0.111111111111111,0.333333333333333,0.555555555555556
"25023505101",2017,141,0,0,11,30,100,127,0,0,10,28,89,14,0,0,1,2,11,0,0,0.0780141843971631,0.212765957446809,0.709219858156028,0.900709219858156,0,0,0.078740157480315,0.220472440944882,0.700787401574803,0.099290780141844,0,0,0.0714285714285714,0.142857142857143,0.785714285714286
"25023505102",2017,92,0,0,6,19,67,88,0,0,5,17,66,4,0,0,1,2,1,0,0,0.0652173913043478,0.206521739130435,0.728260869565217,0.956521739130435,0,0,0.0568181818181818,0.193181818181818,0.75,0.0434782608695652,0,0,0.25,0.5,0.25
"25023505200",2017,113,0,0,5,30,78,107,0,0,5,27,75,6,0,0,0,3,3,0,0,0.0442477876106195,0.265486725663717,0.690265486725664,0.946902654867257,0,0,0.0467289719626168,0.252336448598131,0.700934579439252,0.0530973451327434,0,0,0,0.5,0.5
"25023506101",2017,91,0,0,8,29,54,84,0,0,5,29,50,7,0,0,3,0,4,0,0,0.0879120879120879,0.318681318681319,0.593406593406593,0.923076923076923,0,0,0.0595238095238095,0.345238095238095,0.595238095238095,0.0769230769230769,0,0,0.428571428571429,0,0.571428571428571
"25023506102",2017,77,0,2,13,18,44,70,0,2,11,16,41,7,0,0,2,2,3,0,0.025974025974026,0.168831168831169,0.233766233766234,0.571428571428571,0.909090909090909,0,0.0285714285714286,0.157142857142857,0.228571428571429,0.585714285714286,0.0909090909090909,0,0,0.285714285714286,0.285714285714286,0.428571428571429
"25023506202",2017,24,0,0,5,8,11,24,0,0,5,8,11,0,0,0,0,0,0,0,0,0.208333333333333,0.333333333333333,0.458333333333333,1,0,0,0.208333333333333,0.333333333333333,0.458333333333333,0,0,0,0,0,0
"25023506203",2017,76,0,1,13,24,38,71,0,0,9,24,38,5,0,1,4,0,0,0,0.0131578947368421,0.171052631578947,0.315789473684211,0.5,0.934210526315789,0,0,0.126760563380282,0.338028169014085,0.535211267605634,0.0657894736842105,0,0.2,0.8,0,0
"25023506204",2017,97,0,1,31,25,40,87,0,0,29,21,37,10,0,1,2,4,3,0,0.0103092783505155,0.319587628865979,0.257731958762887,0.412371134020619,0.896907216494845,0,0,0.333333333333333,0.241379310344828,0.425287356321839,0.103092783505155,0,0.1,0.2,0.4,0.3
"25023507101",2017,88,0,0,5,17,66,85,0,0,4,17,64,3,0,0,1,0,2,0,0,0.0568181818181818,0.193181818181818,0.75,0.965909090909091,0,0,0.0470588235294118,0.2,0.752941176470588,0.0340909090909091,0,0,0.333333333333333,0,0.666666666666667
"25023507103",2017,65,0,1,2,2,60,65,0,1,2,2,60,0,0,0,0,0,0,0,0.0153846153846154,0.0307692307692308,0.0307692307692308,0.923076923076923,1,0,0.0153846153846154,0.0307692307692308,0.0307692307692308,0.923076923076923,0,0,0,0,0,0
"25023507104",2017,88,0,0,6,12,70,84,0,0,4,11,69,4,0,0,2,1,1,0,0,0.0681818181818182,0.136363636363636,0.795454545454545,0.954545454545455,0,0,0.0476190476190476,0.130952380952381,0.821428571428571,0.0454545454545455,0,0,0.5,0.25,0.25
"25023508101",2017,95,0,0,23,33,39,91,0,0,21,33,37,4,0,0,2,0,2,0,0,0.242105263157895,0.347368421052632,0.410526315789474,0.957894736842105,0,0,0.230769230769231,0.362637362637363,0.406593406593407,0.0421052631578947,0,0,0.5,0,0.5
"25023508102",2017,78,0,1,26,32,19,73,0,1,24,31,17,5,0,0,2,1,2,0,0.0128205128205128,0.333333333333333,0.41025641025641,0.243589743589744,0.935897435897436,0,0.0136986301369863,0.328767123287671,0.424657534246575,0.232876712328767,0.0641025641025641,0,0,0.4,0.2,0.4
"25023508200",2017,106,0,1,22,42,41,98,0,1,21,38,38,8,0,0,1,4,3,0,0.00943396226415094,0.207547169811321,0.39622641509434,0.386792452830189,0.924528301886792,0,0.0102040816326531,0.214285714285714,0.387755102040816,0.387755102040816,0.0754716981132075,0,0,0.125,0.5,0.375
"25023509101",2017,127,1,0,21,39,66,112,0,0,16,35,61,15,1,0,5,4,5,0.0078740157480315,0,0.165354330708661,0.307086614173228,0.519685039370079,0.881889763779528,0,0,0.142857142857143,0.3125,0.544642857142857,0.118110236220472,0.0666666666666667,0,0.333333333333333,0.266666666666667,0.333333333333333
"25023509102",2017,99,0,0,23,45,31,90,0,0,19,42,29,9,0,0,4,3,2,0,0,0.232323232323232,0.454545454545455,0.313131313131313,0.909090909090909,0,0,0.211111111111111,0.466666666666667,0.322222222222222,0.0909090909090909,0,0,0.444444444444444,0.333333333333333,0.222222222222222
"25023510100",2017,101,0,1,67,30,3,89,0,0,59,27,3,12,0,1,8,3,0,0,0.0099009900990099,0.663366336633663,0.297029702970297,0.0297029702970297,0.881188118811881,0,0,0.662921348314607,0.303370786516854,0.0337078651685393,0.118811881188119,0,0.0833333333333333,0.666666666666667,0.25,0
"25023510200",2017,116,0,4,58,50,4,99,0,2,49,45,3,17,0,2,9,5,1,0,0.0344827586206897,0.5,0.431034482758621,0.0344827586206897,0.853448275862069,0,0.0202020202020202,0.494949494949495,0.454545454545455,0.0303030303030303,0.146551724137931,0,0.117647058823529,0.529411764705882,0.294117647058824,0.0588235294117647
"25023510300",2017,38,0,0,20,15,3,33,0,0,19,11,3,5,0,0,1,4,0,0,0,0.526315789473684,0.394736842105263,0.0789473684210526,0.868421052631579,0,0,0.575757575757576,0.333333333333333,0.0909090909090909,0.131578947368421,0,0,0.2,0.8,0
"25023510400",2017,38,0,4,16,16,2,33,0,2,14,15,2,5,0,2,2,1,0,0,0.105263157894737,0.421052631578947,0.421052631578947,0.0526315789473684,0.868421052631579,0,0.0606060606060606,0.424242424242424,0.454545454545455,0.0606060606060606,0.131578947368421,0,0.4,0.4,0.2,0
"25023510501",2017,78,0,4,52,13,9,64,0,2,44,11,7,14,0,2,8,2,2,0,0.0512820512820513,0.666666666666667,0.166666666666667,0.115384615384615,0.82051282051282,0,0.03125,0.6875,0.171875,0.109375,0.179487179487179,0,0.142857142857143,0.571428571428571,0.142857142857143,0.142857142857143
"25023510502",2017,95,0,6,55,26,8,81,0,5,46,23,7,14,0,1,9,3,1,0,0.0631578947368421,0.578947368421053,0.273684210526316,0.0842105263157895,0.852631578947368,0,0.0617283950617284,0.567901234567901,0.283950617283951,0.0864197530864197,0.147368421052632,0,0.0714285714285714,0.642857142857143,0.214285714285714,0.0714285714285714
"25023510503",2017,38,0,0,21,14,3,32,0,0,17,12,3,6,0,0,4,2,0,0,0,0.552631578947368,0.368421052631579,0.0789473684210526,0.842105263157895,0,0,0.53125,0.375,0.09375,0.157894736842105,0,0,0.666666666666667,0.333333333333333,0
"25023510600",2017,56,0,0,25,20,11,46,0,0,18,18,10,10,0,0,7,2,1,0,0,0.446428571428571,0.357142857142857,0.196428571428571,0.821428571428571,0,0,0.391304347826087,0.391304347826087,0.217391304347826,0.178571428571429,0,0,0.7,0.2,0.1
"25023510700",2017,101,0,2,65,32,2,85,0,0,56,27,2,16,0,2,9,5,0,0,0.0198019801980198,0.643564356435644,0.316831683168317,0.0198019801980198,0.841584158415842,0,0,0.658823529411765,0.317647058823529,0.0235294117647059,0.158415841584158,0,0.125,0.5625,0.3125,0
"25023510800",2017,82,0,4,39,32,7,64,0,3,28,27,6,18,0,1,11,5,1,0,0.0487804878048781,0.475609756097561,0.390243902439024,0.0853658536585366,0.780487804878049,0,0.046875,0.4375,0.421875,0.09375,0.219512195121951,0,0.0555555555555556,0.611111111111111,0.277777777777778,0.0555555555555556
"25023510900",2017,12,0,0,5,6,1,8,0,0,3,5,0,4,0,0,2,1,1,0,0,0.416666666666667,0.5,0.0833333333333333,0.666666666666667,0,0,0.375,0.625,0,0.333333333333333,0,0,0.5,0.25,0.25
"25023511000",2017,53,0,3,27,20,3,45,0,3,25,15,2,8,0,0,2,5,1,0,0.0566037735849057,0.509433962264151,0.377358490566038,0.0566037735849057,0.849056603773585,0,0.0666666666666667,0.555555555555556,0.333333333333333,0.0444444444444444,0.150943396226415,0,0,0.25,0.625,0.125
"25023511100",2017,129,0,1,84,41,3,109,0,1,71,35,2,20,0,0,13,6,1,0,0.00775193798449612,0.651162790697674,0.317829457364341,0.0232558139534884,0.844961240310077,0,0.00917431192660551,0.651376146788991,0.321100917431193,0.018348623853211,0.155038759689922,0,0,0.65,0.3,0.05
"25023511200",2017,79,0,1,49,24,5,69,0,0,42,23,4,10,0,1,7,1,1,0,0.0126582278481013,0.620253164556962,0.30379746835443,0.0632911392405063,0.873417721518987,0,0,0.608695652173913,0.333333333333333,0.0579710144927536,0.126582278481013,0,0.1,0.7,0.1,0.1
"25023511301",2017,99,0,3,64,27,5,84,0,3,52,24,5,15,0,0,12,3,0,0,0.0303030303030303,0.646464646464647,0.272727272727273,0.0505050505050505,0.848484848484849,0,0.0357142857142857,0.619047619047619,0.285714285714286,0.0595238095238095,0.151515151515152,0,0,0.8,0.2,0
"25023511302",2017,51,0,1,37,11,2,48,0,0,36,10,2,3,0,1,1,1,0,0,0.0196078431372549,0.725490196078431,0.215686274509804,0.0392156862745098,0.941176470588235,0,0,0.75,0.208333333333333,0.0416666666666667,0.0588235294117647,0,0.333333333333333,0.333333333333333,0.333333333333333,0
"25023511400",2017,48,0,2,30,15,1,43,0,2,27,13,1,5,0,0,3,2,0,0,0.0416666666666667,0.625,0.3125,0.0208333333333333,0.895833333333333,0,0.0465116279069767,0.627906976744186,0.302325581395349,0.0232558139534884,0.104166666666667,0,0,0.6,0.4,0
"25023511500",2017,68,1,1,43,19,4,56,0,0,36,16,4,12,1,1,7,3,0,0.0147058823529412,0.0147058823529412,0.632352941176471,0.279411764705882,0.0588235294117647,0.823529411764706,0,0,0.642857142857143,0.285714285714286,0.0714285714285714,0.176470588235294,0.0833333333333333,0.0833333333333333,0.583333333333333,0.25,0
"25023511600",2017,114,0,2,50,57,5,94,0,2,40,48,4,20,0,0,10,9,1,0,0.0175438596491228,0.43859649122807,0.5,0.043859649122807,0.824561403508772,0,0.0212765957446809,0.425531914893617,0.51063829787234,0.0425531914893617,0.175438596491228,0,0,0.5,0.45,0.05
"25023511701",2017,96,0,1,56,31,8,86,0,1,49,28,8,10,0,0,7,3,0,0,0.0104166666666667,0.583333333333333,0.322916666666667,0.0833333333333333,0.895833333333333,0,0.0116279069767442,0.569767441860465,0.325581395348837,0.0930232558139535,0.104166666666667,0,0,0.7,0.3,0
"25023511702",2017,37,0,1,15,18,3,31,0,1,9,18,3,6,0,0,6,0,0,0,0.027027027027027,0.405405405405405,0.486486486486487,0.0810810810810811,0.837837837837838,0,0.032258064516129,0.290322580645161,0.580645161290323,0.0967741935483871,0.162162162162162,0,0,1,0,0
"25023520100",2017,110,0,0,27,52,31,99,0,0,22,46,31,11,0,0,5,6,0,0,0,0.245454545454545,0.472727272727273,0.281818181818182,0.9,0,0,0.222222222222222,0.464646464646465,0.313131313131313,0.1,0,0,0.454545454545455,0.545454545454545,0
"25023520201",2017,64,0,1,19,29,15,61,0,1,17,28,15,3,0,0,2,1,0,0,0.015625,0.296875,0.453125,0.234375,0.953125,0,0.0163934426229508,0.278688524590164,0.459016393442623,0.245901639344262,0.046875,0,0,0.666666666666667,0.333333333333333,0
"25023520202",2017,99,0,2,20,46,31,89,0,2,17,40,30,10,0,0,3,6,1,0,0.0202020202020202,0.202020202020202,0.464646464646465,0.313131313131313,0.898989898989899,0,0.0224719101123595,0.191011235955056,0.449438202247191,0.337078651685393,0.101010101010101,0,0,0.3,0.6,0.1
"25023521101",2017,94,0,0,38,34,22,88,0,0,36,30,22,6,0,0,2,4,0,0,0,0.404255319148936,0.361702127659574,0.234042553191489,0.936170212765957,0,0,0.409090909090909,0.340909090909091,0.25,0.0638297872340425,0,0,0.333333333333333,0.666666666666667,0
"25023521102",2017,40,0,0,19,15,6,38,0,0,18,15,5,2,0,0,1,0,1,0,0,0.475,0.375,0.15,0.95,0,0,0.473684210526316,0.394736842105263,0.131578947368421,0.05,0,0,0.5,0,0.5
"25023521201",2017,43,0,0,11,29,3,36,0,0,9,25,2,7,0,0,2,4,1,0,0,0.255813953488372,0.674418604651163,0.0697674418604651,0.837209302325581,0,0,0.25,0.694444444444444,0.0555555555555556,0.162790697674419,0,0,0.285714285714286,0.571428571428571,0.142857142857143
"25023521202",2017,40,0,1,8,23,8,38,0,1,7,22,8,2,0,0,1,1,0,0,0.025,0.2,0.575,0.2,0.95,0,0.0263157894736842,0.184210526315789,0.578947368421053,0.210526315789474,0.05,0,0,0.5,0.5,0
"25023522101",2017,70,0,0,21,36,13,65,0,0,19,33,13,5,0,0,2,3,0,0,0,0.3,0.514285714285714,0.185714285714286,0.928571428571429,0,0,0.292307692307692,0.507692307692308,0.2,0.0714285714285714,0,0,0.4,0.6,0
"25023522102",2017,91,0,3,20,46,22,85,0,1,19,45,20,6,0,2,1,1,2,0,0.032967032967033,0.21978021978022,0.505494505494505,0.241758241758242,0.934065934065934,0,0.0117647058823529,0.223529411764706,0.529411764705882,0.235294117647059,0.0659340659340659,0,0.333333333333333,0.166666666666667,0.166666666666667,0.333333333333333
"25023523100",2017,41,0,0,17,16,8,34,0,0,13,14,7,7,0,0,4,2,1,0,0,0.414634146341463,0.390243902439024,0.195121951219512,0.829268292682927,0,0,0.382352941176471,0.411764705882353,0.205882352941176,0.170731707317073,0,0,0.571428571428571,0.285714285714286,0.142857142857143
"25023523201",2017,44,0,0,12,19,13,40,0,0,11,16,13,4,0,0,1,3,0,0,0,0.272727272727273,0.431818181818182,0.295454545454545,0.909090909090909,0,0,0.275,0.4,0.325,0.0909090909090909,0,0,0.25,0.75,0
"25023523202",2017,126,0,3,40,53,30,105,0,0,30,48,27,21,0,3,10,5,3,0,0.0238095238095238,0.317460317460317,0.420634920634921,0.238095238095238,0.833333333333333,0,0,0.285714285714286,0.457142857142857,0.257142857142857,0.166666666666667,0,0.142857142857143,0.476190476190476,0.238095238095238,0.142857142857143
"25023524101",2017,66,0,1,17,29,19,62,0,0,15,28,19,4,0,1,2,1,0,0,0.0151515151515152,0.257575757575758,0.439393939393939,0.287878787878788,0.939393939393939,0,0,0.241935483870968,0.451612903225806,0.306451612903226,0.0606060606060606,0,0.25,0.5,0.25,0
"25023524102",2017,67,0,1,22,33,11,59,0,0,17,32,10,8,0,1,5,1,1,0,0.0149253731343284,0.328358208955224,0.492537313432836,0.164179104477612,0.880597014925373,0,0,0.288135593220339,0.542372881355932,0.169491525423729,0.119402985074627,0,0.125,0.625,0.125,0.125
"25023525101",2017,131,0,2,47,55,27,118,0,1,42,52,23,13,0,1,5,3,4,0,0.0152671755725191,0.358778625954198,0.419847328244275,0.206106870229008,0.900763358778626,0,0.00847457627118644,0.355932203389831,0.440677966101695,0.194915254237288,0.099236641221374,0,0.0769230769230769,0.384615384615385,0.230769230769231,0.307692307692308
"25023525104",2017,106,0,0,29,41,36,99,0,0,25,38,36,7,0,0,4,3,0,0,0,0.273584905660377,0.386792452830189,0.339622641509434,0.933962264150943,0,0,0.252525252525253,0.383838383838384,0.363636363636364,0.0660377358490566,0,0,0.571428571428571,0.428571428571429,0
"25023525203",2017,67,0,2,32,23,10,56,0,1,27,19,9,11,0,1,5,4,1,0,0.0298507462686567,0.477611940298507,0.343283582089552,0.149253731343284,0.835820895522388,0,0.0178571428571429,0.482142857142857,0.339285714285714,0.160714285714286,0.164179104477612,0,0.0909090909090909,0.454545454545455,0.363636363636364,0.0909090909090909
"25023525204",2017,72,0,0,5,35,32,68,0,0,5,32,31,4,0,0,0,3,1,0,0,0.0694444444444444,0.486111111111111,0.444444444444444,0.944444444444444,0,0,0.0735294117647059,0.470588235294118,0.455882352941176,0.0555555555555556,0,0,0,0.75,0.25
"25023526100",2017,134,0,1,64,46,23,117,0,0,58,38,21,17,0,1,6,8,2,0,0.00746268656716418,0.477611940298507,0.343283582089552,0.171641791044776,0.873134328358209,0,0,0.495726495726496,0.324786324786325,0.179487179487179,0.126865671641791,0,0.0588235294117647,0.352941176470588,0.470588235294118,0.117647058823529
"25023530100",2017,83,0,2,36,39,6,78,0,0,34,38,6,5,0,2,2,1,0,0,0.0240963855421687,0.433734939759036,0.469879518072289,0.072289156626506,0.939759036144578,0,0,0.435897435897436,0.487179487179487,0.0769230769230769,0.0602409638554217,0,0.4,0.4,0.2,0
"25023530200",2017,70,0,2,27,22,19,65,0,2,25,21,17,5,0,0,2,1,2,0,0.0285714285714286,0.385714285714286,0.314285714285714,0.271428571428571,0.928571428571429,0,0.0307692307692308,0.384615384615385,0.323076923076923,0.261538461538462,0.0714285714285714,0,0,0.4,0.2,0.4
"25023530300",2017,71,0,2,17,28,24,65,0,2,14,26,23,6,0,0,3,2,1,0,0.028169014084507,0.23943661971831,0.394366197183099,0.338028169014085,0.915492957746479,0,0.0307692307692308,0.215384615384615,0.4,0.353846153846154,0.0845070422535211,0,0,0.5,0.333333333333333,0.166666666666667
"25023530400",2017,72,0,2,15,36,19,62,0,1,12,30,19,10,0,1,3,6,0,0,0.0277777777777778,0.208333333333333,0.5,0.263888888888889,0.861111111111111,0,0.0161290322580645,0.193548387096774,0.483870967741935,0.306451612903226,0.138888888888889,0,0.1,0.3,0.6,0
"25023530500",2017,65,0,3,16,20,26,57,0,2,14,17,24,8,0,1,2,3,2,0,0.0461538461538462,0.246153846153846,0.307692307692308,0.4,0.876923076923077,0,0.0350877192982456,0.245614035087719,0.298245614035088,0.421052631578947,0.123076923076923,0,0.125,0.25,0.375,0.25
"25023530600",2017,130,0,1,29,53,47,110,0,0,22,45,43,20,0,1,7,8,4,0,0.00769230769230769,0.223076923076923,0.407692307692308,0.361538461538462,0.846153846153846,0,0,0.2,0.409090909090909,0.390909090909091,0.153846153846154,0,0.05,0.35,0.4,0.2
"25023530700",2017,130,0,0,11,33,86,121,0,0,8,32,81,9,0,0,3,1,5,0,0,0.0846153846153846,0.253846153846154,0.661538461538462,0.930769230769231,0,0,0.0661157024793388,0.264462809917355,0.669421487603306,0.0692307692307692,0,0,0.333333333333333,0.111111111111111,0.555555555555556
"25023530801",2017,130,0,0,25,58,47,123,0,0,24,54,45,7,0,0,1,4,2,0,0,0.192307692307692,0.446153846153846,0.361538461538462,0.946153846153846,0,0,0.195121951219512,0.439024390243902,0.365853658536585,0.0538461538461538,0,0,0.142857142857143,0.571428571428571,0.285714285714286
"25023530802",2017,102,0,0,26,36,40,92,0,0,23,32,37,10,0,0,3,4,3,0,0,0.254901960784314,0.352941176470588,0.392156862745098,0.901960784313726,0,0,0.25,0.347826086956522,0.402173913043478,0.0980392156862745,0,0,0.3,0.4,0.3
"25023530901",2017,206,0,2,66,74,64,191,0,1,60,71,59,15,0,1,6,3,5,0,0.00970873786407767,0.320388349514563,0.359223300970874,0.310679611650485,0.927184466019418,0,0.00523560209424084,0.31413612565445,0.371727748691099,0.308900523560209,0.0728155339805825,0,0.0666666666666667,0.4,0.2,0.333333333333333
"25023530902",2017,106,0,3,32,44,27,95,0,1,29,39,26,11,0,2,3,5,1,0,0.0283018867924528,0.30188679245283,0.415094339622642,0.254716981132075,0.89622641509434,0,0.0105263157894737,0.305263157894737,0.410526315789474,0.273684210526316,0.10377358490566,0,0.181818181818182,0.272727272727273,0.454545454545455,0.0909090909090909
"25023540101",2017,72,1,1,20,24,26,65,0,0,18,21,26,7,1,1,2,3,0,0.0138888888888889,0.0138888888888889,0.277777777777778,0.333333333333333,0.361111111111111,0.902777777777778,0,0,0.276923076923077,0.323076923076923,0.4,0.0972222222222222,0.142857142857143,0.142857142857143,0.285714285714286,0.428571428571429,0
"25023540102",2017,44,0,0,13,16,15,36,0,0,10,14,12,8,0,0,3,2,3,0,0,0.295454545454545,0.363636363636364,0.340909090909091,0.818181818181818,0,0,0.277777777777778,0.388888888888889,0.333333333333333,0.181818181818182,0,0,0.375,0.25,0.375
"25023540103",2017,69,0,0,13,38,18,66,0,0,12,36,18,3,0,0,1,2,0,0,0,0.188405797101449,0.550724637681159,0.260869565217391,0.956521739130435,0,0,0.181818181818182,0.545454545454545,0.272727272727273,0.0434782608695652,0,0,0.333333333333333,0.666666666666667,0
"25023541100",2017,73,0,1,12,36,24,70,0,1,12,33,24,3,0,0,0,3,0,0,0.0136986301369863,0.164383561643836,0.493150684931507,0.328767123287671,0.958904109589041,0,0.0142857142857143,0.171428571428571,0.471428571428571,0.342857142857143,0.0410958904109589,0,0,0,1,0
"25023542101",2017,104,0,4,31,51,18,95,0,3,27,49,16,9,0,1,4,2,2,0,0.0384615384615385,0.298076923076923,0.490384615384615,0.173076923076923,0.913461538461538,0,0.0315789473684211,0.284210526315789,0.515789473684211,0.168421052631579,0.0865384615384615,0,0.111111111111111,0.444444444444444,0.222222222222222,0.222222222222222
"25023542102",2017,39,0,4,12,17,6,32,0,0,11,15,6,7,0,4,1,2,0,0,0.102564102564103,0.307692307692308,0.435897435897436,0.153846153846154,0.82051282051282,0,0,0.34375,0.46875,0.1875,0.179487179487179,0,0.571428571428571,0.142857142857143,0.285714285714286,0
"25023542200",2017,101,0,2,28,47,24,87,0,2,23,40,22,14,0,0,5,7,2,0,0.0198019801980198,0.277227722772277,0.465346534653465,0.237623762376238,0.861386138613861,0,0.0229885057471264,0.264367816091954,0.459770114942529,0.252873563218391,0.138613861386139,0,0,0.357142857142857,0.5,0.142857142857143
"25023542300",2017,98,0,1,46,39,12,88,0,0,41,36,11,10,0,1,5,3,1,0,0.0102040816326531,0.469387755102041,0.397959183673469,0.122448979591837,0.897959183673469,0,0,0.465909090909091,0.409090909090909,0.125,0.102040816326531,0,0.1,0.5,0.3,0.1
"25023543100",2017,42,0,0,9,20,13,39,0,0,7,20,12,3,0,0,2,0,1,0,0,0.214285714285714,0.476190476190476,0.30952380952381,0.928571428571429,0,0,0.179487179487179,0.512820512820513,0.307692307692308,0.0714285714285714,0,0,0.666666666666667,0,0.333333333333333
"25023544100",2017,92,0,2,32,46,12,80,0,1,25,43,11,12,0,1,7,3,1,0,0.0217391304347826,0.347826086956522,0.5,0.130434782608696,0.869565217391304,0,0.0125,0.3125,0.5375,0.1375,0.130434782608696,0,0.0833333333333333,0.583333333333333,0.25,0.0833333333333333
"25023544200",2017,130,4,7,52,44,23,92,0,1,31,41,19,38,4,6,21,3,4,0.0307692307692308,0.0538461538461538,0.4,0.338461538461538,0.176923076923077,0.707692307692308,0,0.0108695652173913,0.33695652173913,0.445652173913043,0.206521739130435,0.292307692307692,0.105263157894737,0.157894736842105,0.552631578947368,0.0789473684210526,0.105263157894737
"25023545100",2017,110,0,8,47,39,16,97,0,6,39,36,16,13,0,2,8,3,0,0,0.0727272727272727,0.427272727272727,0.354545454545455,0.145454545454545,0.881818181818182,0,0.0618556701030928,0.402061855670103,0.371134020618557,0.164948453608247,0.118181818181818,0,0.153846153846154,0.615384615384615,0.230769230769231,0
"25023545200",2017,143,2,7,77,50,7,120,1,4,64,45,6,23,1,3,13,5,1,0.013986013986014,0.048951048951049,0.538461538461538,0.34965034965035,0.048951048951049,0.839160839160839,0.00833333333333333,0.0333333333333333,0.533333333333333,0.375,0.05,0.160839160839161,0.0434782608695652,0.130434782608696,0.565217391304348,0.217391304347826,0.0434782608695652
"25023545300",2017,97,0,9,36,27,25,83,0,5,31,23,24,14,0,4,5,4,1,0,0.0927835051546392,0.371134020618557,0.278350515463918,0.257731958762887,0.855670103092783,0,0.0602409638554217,0.373493975903614,0.27710843373494,0.289156626506024,0.144329896907216,0,0.285714285714286,0.357142857142857,0.285714285714286,0.0714285714285714
"25023545400",2017,115,0,8,49,34,24,98,0,3,45,27,23,17,0,5,4,7,1,0,0.0695652173913043,0.426086956521739,0.295652173913043,0.208695652173913,0.852173913043478,0,0.0306122448979592,0.459183673469388,0.275510204081633,0.23469387755102,0.147826086956522,0,0.294117647058824,0.235294117647059,0.411764705882353,0.0588235294117647
"25023560100",2017,88,0,0,15,23,50,81,0,0,12,20,49,7,0,0,3,3,1,0,0,0.170454545454545,0.261363636363636,0.568181818181818,0.920454545454545,0,0,0.148148148148148,0.246913580246914,0.604938271604938,0.0795454545454545,0,0,0.428571428571429,0.428571428571429,0.142857142857143
"25023561100",2017,86,0,0,16,25,45,81,0,0,13,25,43,5,0,0,3,0,2,0,0,0.186046511627907,0.290697674418605,0.523255813953488,0.941860465116279,0,0,0.160493827160494,0.308641975308642,0.530864197530864,0.0581395348837209,0,0,0.6,0,0.4
"25023561200",2017,13,0,1,4,3,5,11,0,1,2,3,5,2,0,0,2,0,0,0,0.0769230769230769,0.307692307692308,0.230769230769231,0.384615384615385,0.846153846153846,0,0.0909090909090909,0.181818181818182,0.272727272727273,0.454545454545455,0.153846153846154,0,0,1,0,0
"25025000100",2017,19,0,0,0,7,12,18,0,0,0,6,12,1,0,0,0,1,0,0,0,0,0.368421052631579,0.631578947368421,0.947368421052632,0,0,0,0.333333333333333,0.666666666666667,0.0526315789473684,0,0,0,1,0
"25025000201",2017,16,0,0,2,6,8,16,0,0,2,6,8,0,0,0,0,0,0,0,0,0.125,0.375,0.5,1,0,0,0.125,0.375,0.5,0,0,0,0,0,0
"25025000202",2017,16,0,0,0,3,13,15,0,0,0,3,12,1,0,0,0,0,1,0,0,0,0.1875,0.8125,0.9375,0,0,0,0.2,0.8,0.0625,0,0,0,0,1
"25025000301",2017,23,0,0,6,4,13,20,0,0,5,3,12,3,0,0,1,1,1,0,0,0.260869565217391,0.173913043478261,0.565217391304348,0.869565217391304,0,0,0.25,0.15,0.6,0.130434782608696,0,0,0.333333333333333,0.333333333333333,0.333333333333333
"25025000302",2017,32,1,0,6,7,18,30,1,0,5,7,17,2,0,0,1,0,1,0.03125,0,0.1875,0.21875,0.5625,0.9375,0.0333333333333333,0,0.166666666666667,0.233333333333333,0.566666666666667,0.0625,0,0,0.5,0,0.5
"25025000401",2017,34,0,0,4,8,22,33,0,0,4,8,21,1,0,0,0,0,1,0,0,0.117647058823529,0.235294117647059,0.647058823529412,0.970588235294118,0,0,0.121212121212121,0.242424242424242,0.636363636363636,0.0294117647058824,0,0,0,0,1
"25025000402",2017,26,1,2,3,5,15,24,1,1,3,4,15,2,0,1,0,1,0,0.0384615384615385,0.0769230769230769,0.115384615384615,0.192307692307692,0.576923076923077,0.923076923076923,0.0416666666666667,0.0416666666666667,0.125,0.166666666666667,0.625,0.0769230769230769,0,0.5,0,0.5,0
"25025000502",2017,21,0,0,2,7,12,20,0,0,2,7,11,1,0,0,0,0,1,0,0,0.0952380952380952,0.333333333333333,0.571428571428571,0.952380952380952,0,0,0.1,0.35,0.55,0.0476190476190476,0,0,0,0,1
"25025000503",2017,19,0,1,7,1,10,16,0,0,7,1,8,3,0,1,0,0,2,0,0.0526315789473684,0.368421052631579,0.0526315789473684,0.526315789473684,0.842105263157895,0,0,0.4375,0.0625,0.5,0.157894736842105,0,0.333333333333333,0,0,0.666666666666667
"25025000504",2017,25,0,0,3,7,15,23,0,0,3,6,14,2,0,0,0,1,1,0,0,0.12,0.28,0.6,0.92,0,0,0.130434782608696,0.260869565217391,0.608695652173913,0.08,0,0,0,0.5,0.5
"25025000601",2017,16,0,0,4,2,10,14,0,0,4,1,9,2,0,0,0,1,1,0,0,0.25,0.125,0.625,0.875,0,0,0.285714285714286,0.0714285714285714,0.642857142857143,0.125,0,0,0,0.5,0.5
"25025000602",2017,13,0,0,2,2,9,12,0,0,1,2,9,1,0,0,1,0,0,0,0,0.153846153846154,0.153846153846154,0.692307692307692,0.923076923076923,0,0,0.0833333333333333,0.166666666666667,0.75,0.0769230769230769,0,0,1,0,0
"25025000701",2017,12,0,0,4,4,4,9,0,0,2,4,3,3,0,0,2,0,1,0,0,0.333333333333333,0.333333333333333,0.333333333333333,0.75,0,0,0.222222222222222,0.444444444444444,0.333333333333333,0.25,0,0,0.666666666666667,0,0.333333333333333
"25025000704",2017,22,0,0,3,9,10,20,0,0,2,8,10,2,0,0,1,1,0,0,0,0.136363636363636,0.409090909090909,0.454545454545455,0.909090909090909,0,0,0.1,0.4,0.5,0.0909090909090909,0,0,0.5,0.5,0
"25025000802",2017,20,0,0,0,8,12,19,0,0,0,8,11,1,0,0,0,0,1,0,0,0,0.4,0.6,0.95,0,0,0,0.421052631578947,0.578947368421053,0.05,0,0,0,0,1
"25025010103",2017,4,0,0,0,0,4,4,0,0,0,0,4,0,0,0,0,0,0,0,0,0,0,1,1,0,0,0,0,1,0,0,0,0,0,0
"25025010104",2017,30,0,0,1,6,23,28,0,0,0,6,22,2,0,0,1,0,1,0,0,0.0333333333333333,0.2,0.766666666666667,0.933333333333333,0,0,0,0.214285714285714,0.785714285714286,0.0666666666666667,0,0,0.5,0,0.5
"25025010203",2017,24,0,0,0,7,17,20,0,0,0,7,13,4,0,0,0,0,4,0,0,0,0.291666666666667,0.708333333333333,0.833333333333333,0,0,0,0.35,0.65,0.166666666666667,0,0,0,0,1
"25025010204",2017,12,0,0,1,1,10,10,0,0,0,1,9,2,0,0,1,0,1,0,0,0.0833333333333333,0.0833333333333333,0.833333333333333,0.833333333333333,0,0,0,0.1,0.9,0.166666666666667,0,0,0.5,0,0.5
"25025010300",2017,3,0,0,1,1,1,1,0,0,0,1,0,2,0,0,1,0,1,0,0,0.333333333333333,0.333333333333333,0.333333333333333,0.333333333333333,0,0,0,1,0,0.666666666666667,0,0,0.5,0,0.5
"25025010403",2017,27,0,0,3,4,20,26,0,0,3,4,19,1,0,0,0,0,1,0,0,0.111111111111111,0.148148148148148,0.740740740740741,0.962962962962963,0,0,0.115384615384615,0.153846153846154,0.730769230769231,0.037037037037037,0,0,0,0,1
"25025010404",2017,3,0,0,0,0,3,3,0,0,0,0,3,0,0,0,0,0,0,0,0,0,0,1,1,0,0,0,0,1,0,0,0,0,0,0
"25025010405",2017,6,0,0,0,0,6,6,0,0,0,0,6,0,0,0,0,0,0,0,0,0,0,1,1,0,0,0,0,1,0,0,0,0,0,0
"25025010408",2017,6,0,0,0,3,3,6,0,0,0,3,3,0,0,0,0,0,0,0,0,0,0.5,0.5,1,0,0,0,0.5,0.5,0,0,0,0,0,0
"25025010500",2017,7,0,0,0,0,7,7,0,0,0,0,7,0,0,0,0,0,0,0,0,0,0,1,1,0,0,0,0,1,0,0,0,0,0,0
"25025010600",2017,22,0,0,1,2,19,22,0,0,1,2,19,0,0,0,0,0,0,0,0,0.0454545454545455,0.0909090909090909,0.863636363636364,1,0,0,0.0454545454545455,0.0909090909090909,0.863636363636364,0,0,0,0,0,0
"25025010701",2017,17,0,0,0,2,15,17,0,0,0,2,15,0,0,0,0,0,0,0,0,0,0.117647058823529,0.882352941176471,1,0,0,0,0.117647058823529,0.882352941176471,0,0,0,0,0,0
"25025010702",2017,25,0,0,0,5,20,25,0,0,0,5,20,0,0,0,0,0,0,0,0,0,0.2,0.8,1,0,0,0,0.2,0.8,0,0,0,0,0,0
"25025010801",2017,44,0,0,1,4,39,42,0,0,1,3,38,2,0,0,0,1,1,0,0,0.0227272727272727,0.0909090909090909,0.886363636363636,0.954545454545455,0,0,0.0238095238095238,0.0714285714285714,0.904761904761905,0.0454545454545455,0,0,0,0.5,0.5
"25025010802",2017,59,0,0,2,6,51,56,0,0,2,6,48,3,0,0,0,0,3,0,0,0.0338983050847458,0.101694915254237,0.864406779661017,0.949152542372881,0,0,0.0357142857142857,0.107142857142857,0.857142857142857,0.0508474576271186,0,0,0,0,1
"25025020101",2017,68,0,1,0,7,60,63,0,0,0,6,57,5,0,1,0,1,3,0,0.0147058823529412,0,0.102941176470588,0.882352941176471,0.926470588235294,0,0,0,0.0952380952380952,0.904761904761905,0.0735294117647059,0,0.2,0,0.2,0.6
"25025020200",2017,46,0,0,4,7,35,43,0,0,4,7,32,3,0,0,0,0,3,0,0,0.0869565217391304,0.152173913043478,0.760869565217391,0.934782608695652,0,0,0.0930232558139535,0.162790697674419,0.744186046511628,0.0652173913043478,0,0,0,0,1
"25025020301",2017,11,0,0,2,4,5,10,0,0,2,4,4,1,0,0,0,0,1,0,0,0.181818181818182,0.363636363636364,0.454545454545455,0.909090909090909,0,0,0.2,0.4,0.4,0.0909090909090909,0,0,0,0,1
"25025020302",2017,20,0,0,0,2,18,18,0,0,0,2,16,2,0,0,0,0,2,0,0,0,0.1,0.9,0.9,0,0,0,0.111111111111111,0.888888888888889,0.1,0,0,0,0,1
"25025020303",2017,48,0,0,2,3,43,42,0,0,2,3,37,6,0,0,0,0,6,0,0,0.0416666666666667,0.0625,0.895833333333333,0.875,0,0,0.0476190476190476,0.0714285714285714,0.880952380952381,0.125,0,0,0,0,1
"25025030100",2017,19,0,0,2,7,10,16,0,0,2,6,8,3,0,0,0,1,2,0,0,0.105263157894737,0.368421052631579,0.526315789473684,0.842105263157895,0,0,0.125,0.375,0.5,0.157894736842105,0,0,0,0.333333333333333,0.666666666666667
"25025030200",2017,10,0,0,1,1,8,9,0,0,0,1,8,1,0,0,1,0,0,0,0,0.1,0.1,0.8,0.9,0,0,0,0.111111111111111,0.888888888888889,0.1,0,0,1,0,0
"25025030300",2017,66,0,1,1,5,59,56,0,0,1,4,51,10,0,1,0,1,8,0,0.0151515151515152,0.0151515151515152,0.0757575757575758,0.893939393939394,0.848484848484849,0,0,0.0178571428571429,0.0714285714285714,0.910714285714286,0.151515151515152,0,0.1,0,0.1,0.8
"25025030400",2017,27,0,0,2,4,21,26,0,0,2,4,20,1,0,0,0,0,1,0,0,0.0740740740740741,0.148148148148148,0.777777777777778,0.962962962962963,0,0,0.0769230769230769,0.153846153846154,0.769230769230769,0.037037037037037,0,0,0,0,1
"25025030500",2017,40,0,0,2,4,34,39,0,0,2,4,33,1,0,0,0,0,1,0,0,0.05,0.1,0.85,0.975,0,0,0.0512820512820513,0.102564102564103,0.846153846153846,0.025,0,0,0,0,1
"25025040100",2017,60,0,0,2,10,48,57,0,0,2,9,46,3,0,0,0,1,2,0,0,0.0333333333333333,0.166666666666667,0.8,0.95,0,0,0.0350877192982456,0.157894736842105,0.807017543859649,0.05,0,0,0,0.333333333333333,0.666666666666667
"25025040200",2017,34,0,0,1,5,28,31,0,0,0,4,27,3,0,0,1,1,1,0,0,0.0294117647058824,0.147058823529412,0.823529411764706,0.911764705882353,0,0,0,0.129032258064516,0.870967741935484,0.0882352941176471,0,0,0.333333333333333,0.333333333333333,0.333333333333333
"25025040300",2017,114,0,0,4,18,92,112,0,0,4,16,92,2,0,0,0,2,0,0,0,0.0350877192982456,0.157894736842105,0.807017543859649,0.982456140350877,0,0,0.0357142857142857,0.142857142857143,0.821428571428571,0.0175438596491228,0,0,0,1,0
"25025040401",2017,44,0,0,2,7,35,43,0,0,2,7,34,1,0,0,0,0,1,0,0,0.0454545454545455,0.159090909090909,0.795454545454545,0.977272727272727,0,0,0.0465116279069767,0.162790697674419,0.790697674418605,0.0227272727272727,0,0,0,0,1
"25025040600",2017,89,0,0,4,29,56,85,0,0,4,27,54,4,0,0,0,2,2,0,0,0.0449438202247191,0.325842696629214,0.629213483146067,0.955056179775281,0,0,0.0470588235294118,0.317647058823529,0.635294117647059,0.0449438202247191,0,0,0,0.5,0.5
"25025040801",2017,49,0,0,3,6,40,46,0,0,3,6,37,3,0,0,0,0,3,0,0,0.0612244897959184,0.122448979591837,0.816326530612245,0.938775510204082,0,0,0.0652173913043478,0.130434782608696,0.804347826086957,0.0612244897959184,0,0,0,0,1
"25025050101",2017,43,0,0,6,19,18,43,0,0,6,19,18,0,0,0,0,0,0,0,0,0.13953488372093,0.441860465116279,0.418604651162791,1,0,0,0.13953488372093,0.441860465116279,0.418604651162791,0,0,0,0,0,0
"25025050200",2017,56,0,1,11,19,25,56,0,1,11,19,25,0,0,0,0,0,0,0,0.0178571428571429,0.196428571428571,0.339285714285714,0.446428571428571,1,0,0.0178571428571429,0.196428571428571,0.339285714285714,0.446428571428571,0,0,0,0,0,0
"25025050300",2017,5,0,0,3,0,2,5,0,0,3,0,2,0,0,0,0,0,0,0,0,0.6,0,0.4,1,0,0,0.6,0,0.4,0,0,0,0,0,0
"25025050400",2017,25,0,0,3,8,14,23,0,0,3,8,12,2,0,0,0,0,2,0,0,0.12,0.32,0.56,0.92,0,0,0.130434782608696,0.347826086956522,0.521739130434783,0.08,0,0,0,0,1
"25025050500",2017,14,0,0,4,6,4,13,0,0,3,6,4,1,0,0,1,0,0,0,0,0.285714285714286,0.428571428571429,0.285714285714286,0.928571428571429,0,0,0.230769230769231,0.461538461538462,0.307692307692308,0.0714285714285714,0,0,1,0,0
"25025050600",2017,21,0,0,2,8,11,20,0,0,2,8,10,1,0,0,0,0,1,0,0,0.0952380952380952,0.380952380952381,0.523809523809524,0.952380952380952,0,0,0.1,0.4,0.5,0.0476190476190476,0,0,0,0,1
"25025050700",2017,55,1,0,4,24,26,52,1,0,2,24,25,3,0,0,2,0,1,0.0181818181818182,0,0.0727272727272727,0.436363636363636,0.472727272727273,0.945454545454545,0.0192307692307692,0,0.0384615384615385,0.461538461538462,0.480769230769231,0.0545454545454545,0,0,0.666666666666667,0,0.333333333333333
"25025050901",2017,46,0,0,15,17,14,40,0,0,13,17,10,6,0,0,2,0,4,0,0,0.326086956521739,0.369565217391304,0.304347826086957,0.869565217391304,0,0,0.325,0.425,0.25,0.130434782608696,0,0,0.333333333333333,0,0.666666666666667
"25025051000",2017,31,0,1,3,16,11,26,0,1,3,12,10,5,0,0,0,4,1,0,0.032258064516129,0.0967741935483871,0.516129032258065,0.354838709677419,0.838709677419355,0,0.0384615384615385,0.115384615384615,0.461538461538462,0.384615384615385,0.161290322580645,0,0,0,0.8,0.2
"25025051101",2017,35,0,0,8,14,13,29,0,0,6,12,11,6,0,0,2,2,2,0,0,0.228571428571429,0.4,0.371428571428571,0.828571428571429,0,0,0.206896551724138,0.413793103448276,0.379310344827586,0.171428571428571,0,0,0.333333333333333,0.333333333333333,0.333333333333333
"25025051200",2017,54,0,0,8,16,30,48,0,0,7,14,27,6,0,0,1,2,3,0,0,0.148148148148148,0.296296296296296,0.555555555555556,0.888888888888889,0,0,0.145833333333333,0.291666666666667,0.5625,0.111111111111111,0,0,0.166666666666667,0.333333333333333,0.5
"25025060101",2017,89,0,0,10,13,66,84,0,0,7,12,65,5,0,0,3,1,1,0,0,0.112359550561798,0.146067415730337,0.741573033707865,0.943820224719101,0,0,0.0833333333333333,0.142857142857143,0.773809523809524,0.0561797752808989,0,0,0.6,0.2,0.2
"25025060200",2017,49,0,0,3,10,36,46,0,0,3,10,33,3,0,0,0,0,3,0,0,0.0612244897959184,0.204081632653061,0.73469387755102,0.938775510204082,0,0,0.0652173913043478,0.217391304347826,0.717391304347826,0.0612244897959184,0,0,0,0,1
"25025060301",2017,79,0,0,5,18,56,74,0,0,3,18,53,5,0,0,2,0,3,0,0,0.0632911392405063,0.227848101265823,0.708860759493671,0.936708860759494,0,0,0.0405405405405405,0.243243243243243,0.716216216216216,0.0632911392405063,0,0,0.4,0,0.6
"25025060400",2017,85,0,0,4,23,58,83,0,0,4,23,56,2,0,0,0,0,2,0,0,0.0470588235294118,0.270588235294118,0.682352941176471,0.976470588235294,0,0,0.0481927710843374,0.27710843373494,0.674698795180723,0.0235294117647059,0,0,0,0,1
"25025060501",2017,167,0,0,8,35,124,153,0,0,7,31,115,14,0,0,1,4,9,0,0,0.0479041916167665,0.209580838323353,0.74251497005988,0.916167664670659,0,0,0.0457516339869281,0.202614379084967,0.751633986928105,0.0838323353293413,0,0,0.0714285714285714,0.285714285714286,0.642857142857143
"25025060600",2017,75,0,0,6,17,52,69,0,0,5,15,49,6,0,0,1,2,3,0,0,0.08,0.226666666666667,0.693333333333333,0.92,0,0,0.072463768115942,0.217391304347826,0.710144927536232,0.08,0,0,0.166666666666667,0.333333333333333,0.5
"25025060800",2017,151,0,1,16,39,95,149,0,1,16,38,94,2,0,0,0,1,1,0,0.00662251655629139,0.105960264900662,0.258278145695364,0.629139072847682,0.986754966887417,0,0.00671140939597315,0.10738255033557,0.25503355704698,0.630872483221476,0.0132450331125828,0,0,0,0.5,0.5
"25025061000",2017,38,0,0,1,16,21,37,0,0,1,15,21,1,0,0,0,1,0,0,0,0.0263157894736842,0.421052631578947,0.552631578947368,0.973684210526316,0,0,0.027027027027027,0.405405405405405,0.567567567567568,0.0263157894736842,0,0,0,1,0
"25025061200",2017,130,0,0,12,27,91,112,0,0,11,24,77,18,0,0,1,3,14,0,0,0.0923076923076923,0.207692307692308,0.7,0.861538461538462,0,0,0.0982142857142857,0.214285714285714,0.6875,0.138461538461538,0,0,0.0555555555555556,0.166666666666667,0.777777777777778
"25025070101",2017,127,1,1,4,15,106,113,0,0,2,12,99,14,1,1,2,3,7,0.0078740157480315,0.0078740157480315,0.031496062992126,0.118110236220472,0.834645669291339,0.889763779527559,0,0,0.0176991150442478,0.106194690265487,0.876106194690266,0.110236220472441,0.0714285714285714,0.0714285714285714,0.142857142857143,0.214285714285714,0.5
"25025070200",2017,17,0,0,2,1,14,16,0,0,2,1,13,1,0,0,0,0,1,0,0,0.117647058823529,0.0588235294117647,0.823529411764706,0.941176470588235,0,0,0.125,0.0625,0.8125,0.0588235294117647,0,0,0,0,1
"25025070300",2017,69,1,0,1,4,63,64,0,0,1,3,60,5,1,0,0,1,3,0.0144927536231884,0,0.0144927536231884,0.0579710144927536,0.91304347826087,0.927536231884058,0,0,0.015625,0.046875,0.9375,0.072463768115942,0.2,0,0,0.2,0.6
"25025070402",2017,35,0,0,1,3,31,31,0,0,1,3,27,4,0,0,0,0,4,0,0,0.0285714285714286,0.0857142857142857,0.885714285714286,0.885714285714286,0,0,0.032258064516129,0.0967741935483871,0.870967741935484,0.114285714285714,0,0,0,0,1
"25025070500",2017,95,0,0,0,13,82,92,0,0,0,11,81,3,0,0,0,2,1,0,0,0,0.136842105263158,0.863157894736842,0.968421052631579,0,0,0,0.119565217391304,0.880434782608696,0.0315789473684211,0,0,0,0.666666666666667,0.333333333333333
"25025070600",2017,52,0,0,2,3,47,50,0,0,2,3,45,2,0,0,0,0,2,0,0,0.0384615384615385,0.0576923076923077,0.903846153846154,0.961538461538462,0,0,0.04,0.06,0.9,0.0384615384615385,0,0,0,0,1
"25025070700",2017,22,0,0,4,0,18,22,0,0,4,0,18,0,0,0,0,0,0,0,0,0.181818181818182,0,0.818181818181818,1,0,0,0.181818181818182,0,0.818181818181818,0,0,0,0,0,0
"25025070800",2017,48,0,0,0,9,39,47,0,0,0,8,39,1,0,0,0,1,0,0,0,0,0.1875,0.8125,0.979166666666667,0,0,0,0.170212765957447,0.829787234042553,0.0208333333333333,0,0,0,1,0
"25025070900",2017,56,0,0,1,9,46,54,0,0,1,9,44,2,0,0,0,0,2,0,0,0.0178571428571429,0.160714285714286,0.821428571428571,0.964285714285714,0,0,0.0185185185185185,0.166666666666667,0.814814814814815,0.0357142857142857,0,0,0,0,1
"25025071101",2017,59,0,0,8,7,44,55,0,0,8,7,40,4,0,0,0,0,4,0,0,0.135593220338983,0.11864406779661,0.745762711864407,0.932203389830508,0,0,0.145454545454545,0.127272727272727,0.727272727272727,0.0677966101694915,0,0,0,0,1
"25025071201",2017,37,0,0,4,6,27,34,0,0,4,4,26,3,0,0,0,2,1,0,0,0.108108108108108,0.162162162162162,0.72972972972973,0.918918918918919,0,0,0.117647058823529,0.117647058823529,0.764705882352941,0.0810810810810811,0,0,0,0.666666666666667,0.333333333333333
"25025080100",2017,3,0,0,1,1,1,3,0,0,1,1,1,0,0,0,0,0,0,0,0,0.333333333333333,0.333333333333333,0.333333333333333,1,0,0,0.333333333333333,0.333333333333333,0.333333333333333,0,0,0,0,0,0
"25025080300",2017,12,0,0,4,6,2,8,0,0,2,4,2,4,0,0,2,2,0,0,0,0.333333333333333,0.5,0.166666666666667,0.666666666666667,0,0,0.25,0.5,0.25,0.333333333333333,0,0,0.5,0.5,0
"25025080401",2017,7,0,0,1,1,5,7,0,0,1,1,5,0,0,0,0,0,0,0,0,0.142857142857143,0.142857142857143,0.714285714285714,1,0,0,0.142857142857143,0.142857142857143,0.714285714285714,0,0,0,0,0,0
"25025080500",2017,4,0,0,0,0,4,4,0,0,0,0,4,0,0,0,0,0,0,0,0,0,0,1,1,0,0,0,0,1,0,0,0,0,0,0
"25025080601",2017,3,0,0,0,0,3,3,0,0,0,0,3,0,0,0,0,0,0,0,0,0,0,1,1,0,0,0,0,1,0,0,0,0,0,0
"25025080900",2017,14,0,0,0,2,12,11,0,0,0,2,9,3,0,0,0,0,3,0,0,0,0.142857142857143,0.857142857142857,0.785714285714286,0,0,0,0.181818181818182,0.818181818181818,0.214285714285714,0,0,0,0,1
"25025081001",2017,59,0,6,41,5,7,51,0,5,37,4,5,8,0,1,4,1,2,0,0.101694915254237,0.694915254237288,0.0847457627118644,0.11864406779661,0.864406779661017,0,0.0980392156862745,0.725490196078431,0.0784313725490196,0.0980392156862745,0.135593220338983,0,0.125,0.5,0.125,0.25
"25025081100",2017,20,0,0,4,5,11,19,0,0,4,4,11,1,0,0,0,1,0,0,0,0.2,0.25,0.55,0.95,0,0,0.210526315789474,0.210526315789474,0.578947368421053,0.05,0,0,0,1,0
"25025081200",2017,12,0,0,2,4,6,10,0,0,2,4,4,2,0,0,0,0,2,0,0,0.166666666666667,0.333333333333333,0.5,0.833333333333333,0,0,0.2,0.4,0.4,0.166666666666667,0,0,0,0,1
"25025081300",2017,14,0,0,4,6,4,12,0,0,3,6,3,2,0,0,1,0,1,0,0,0.285714285714286,0.428571428571429,0.285714285714286,0.857142857142857,0,0,0.25,0.5,0.25,0.142857142857143,0,0,0.5,0,0.5
"25025081400",2017,19,0,0,1,3,15,19,0,0,1,3,15,0,0,0,0,0,0,0,0,0.0526315789473684,0.157894736842105,0.789473684210526,1,0,0,0.0526315789473684,0.157894736842105,0.789473684210526,0,0,0,0,0,0
"25025081500",2017,18,0,0,5,3,10,14,0,0,3,3,8,4,0,0,2,0,2,0,0,0.277777777777778,0.166666666666667,0.555555555555556,0.777777777777778,0,0,0.214285714285714,0.214285714285714,0.571428571428571,0.222222222222222,0,0,0.5,0,0.5
"25025081700",2017,18,0,0,4,9,5,17,0,0,4,8,5,1,0,0,0,1,0,0,0,0.222222222222222,0.5,0.277777777777778,0.944444444444444,0,0,0.235294117647059,0.470588235294118,0.294117647058824,0.0555555555555556,0,0,0,1,0
"25025081800",2017,20,0,0,3,6,11,17,0,0,2,6,9,3,0,0,1,0,2,0,0,0.15,0.3,0.55,0.85,0,0,0.117647058823529,0.352941176470588,0.529411764705882,0.15,0,0,0.333333333333333,0,0.666666666666667
"25025081900",2017,20,0,0,3,12,5,14,0,0,1,10,3,6,0,0,2,2,2,0,0,0.15,0.6,0.25,0.7,0,0,0.0714285714285714,0.714285714285714,0.214285714285714,0.3,0,0,0.333333333333333,0.333333333333333,0.333333333333333
"25025082000",2017,17,1,0,4,6,6,14,0,0,4,5,5,3,1,0,0,1,1,0.0588235294117647,0,0.235294117647059,0.352941176470588,0.352941176470588,0.823529411764706,0,0,0.285714285714286,0.357142857142857,0.357142857142857,0.176470588235294,0.333333333333333,0,0,0.333333333333333,0.333333333333333
"25025082100",2017,6,0,0,2,2,2,4,0,0,1,1,2,2,0,0,1,1,0,0,0,0.333333333333333,0.333333333333333,0.333333333333333,0.666666666666667,0,0,0.25,0.25,0.5,0.333333333333333,0,0,0.5,0.5,0
"25025090100",2017,20,0,0,4,12,4,15,0,0,2,10,3,5,0,0,2,2,1,0,0,0.2,0.6,0.2,0.75,0,0,0.133333333333333,0.666666666666667,0.2,0.25,0,0,0.4,0.4,0.2
"25025090200",2017,24,0,0,9,10,5,22,0,0,7,10,5,2,0,0,2,0,0,0,0,0.375,0.416666666666667,0.208333333333333,0.916666666666667,0,0,0.318181818181818,0.454545454545455,0.227272727272727,0.0833333333333333,0,0,1,0,0
"25025090300",2017,14,0,0,5,6,3,14,0,0,5,6,3,0,0,0,0,0,0,0,0,0.357142857142857,0.428571428571429,0.214285714285714,1,0,0,0.357142857142857,0.428571428571429,0.214285714285714,0,0,0,0,0,0
"25025090400",2017,12,0,0,1,9,2,9,0,0,1,6,2,3,0,0,0,3,0,0,0,0.0833333333333333,0.75,0.166666666666667,0.75,0,0,0.111111111111111,0.666666666666667,0.222222222222222,0.25,0,0,0,1,0
"25025090600",2017,12,0,0,1,5,6,10,0,0,1,4,5,2,0,0,0,1,1,0,0,0.0833333333333333,0.416666666666667,0.5,0.833333333333333,0,0,0.1,0.4,0.5,0.166666666666667,0,0,0,0.5,0.5
"25025090700",2017,52,0,0,12,12,28,48,0,0,10,10,28,4,0,0,2,2,0,0,0,0.230769230769231,0.230769230769231,0.538461538461538,0.923076923076923,0,0,0.208333333333333,0.208333333333333,0.583333333333333,0.0769230769230769,0,0,0.5,0.5,0
"25025091001",2017,37,0,0,5,13,19,32,0,0,4,13,15,5,0,0,1,0,4,0,0,0.135135135135135,0.351351351351351,0.513513513513513,0.864864864864865,0,0,0.125,0.40625,0.46875,0.135135135135135,0,0,0.2,0,0.8
"25025091100",2017,62,0,0,2,20,40,57,0,0,1,19,37,5,0,0,1,1,3,0,0,0.032258064516129,0.32258064516129,0.645161290322581,0.919354838709677,0,0,0.0175438596491228,0.333333333333333,0.649122807017544,0.0806451612903226,0,0,0.2,0.2,0.6
"25025091200",2017,54,0,0,6,21,27,50,0,0,5,18,27,4,0,0,1,3,0,0,0,0.111111111111111,0.388888888888889,0.5,0.925925925925926,0,0,0.1,0.36,0.54,0.0740740740740741,0,0,0.25,0.75,0
"25025091300",2017,12,0,0,0,6,6,10,0,0,0,5,5,2,0,0,0,1,1,0,0,0,0.5,0.5,0.833333333333333,0,0,0,0.5,0.5,0.166666666666667,0,0,0,0.5,0.5
"25025091400",2017,8,0,0,3,1,4,7,0,0,3,1,3,1,0,0,0,0,1,0,0,0.375,0.125,0.5,0.875,0,0,0.428571428571429,0.142857142857143,0.428571428571429,0.125,0,0,0,0,1
"25025091500",2017,59,0,0,10,26,23,56,0,0,10,23,23,3,0,0,0,3,0,0,0,0.169491525423729,0.440677966101695,0.389830508474576,0.949152542372881,0,0,0.178571428571429,0.410714285714286,0.410714285714286,0.0508474576271186,0,0,0,1,0
"25025091600",2017,33,0,0,10,15,8,29,0,0,9,13,7,4,0,0,1,2,1,0,0,0.303030303030303,0.454545454545455,0.242424242424242,0.878787878787879,0,0,0.310344827586207,0.448275862068966,0.241379310344828,0.121212121212121,0,0,0.25,0.5,0.25
"25025091700",2017,17,0,1,3,3,10,15,0,0,2,3,10,2,0,1,1,0,0,0,0.0588235294117647,0.176470588235294,0.176470588235294,0.588235294117647,0.882352941176471,0,0,0.133333333333333,0.2,0.666666666666667,0.117647058823529,0,0.5,0.5,0,0
"25025091800",2017,14,0,0,2,7,5,10,0,0,2,4,4,4,0,0,0,3,1,0,0,0.142857142857143,0.5,0.357142857142857,0.714285714285714,0,0,0.2,0.4,0.4,0.285714285714286,0,0,0,0.75,0.25
"25025091900",2017,17,0,0,7,7,3,16,0,0,6,7,3,1,0,0,1,0,0,0,0,0.411764705882353,0.411764705882353,0.176470588235294,0.941176470588235,0,0,0.375,0.4375,0.1875,0.0588235294117647,0,0,1,0,0
"25025092000",2017,38,1,0,9,15,13,22,0,0,5,10,7,16,1,0,4,5,6,0.0263157894736842,0,0.236842105263158,0.394736842105263,0.342105263157895,0.578947368421053,0,0,0.227272727272727,0.454545454545455,0.318181818181818,0.421052631578947,0.0625,0,0.25,0.3125,0.375
"25025092101",2017,96,0,1,18,38,39,84,0,1,14,33,36,12,0,0,4,5,3,0,0.0104166666666667,0.1875,0.395833333333333,0.40625,0.875,0,0.0119047619047619,0.166666666666667,0.392857142857143,0.428571428571429,0.125,0,0,0.333333333333333,0.416666666666667,0.25
"25025092200",2017,24,0,0,0,13,11,24,0,0,0,13,11,0,0,0,0,0,0,0,0,0,0.541666666666667,0.458333333333333,1,0,0,0,0.541666666666667,0.458333333333333,0,0,0,0,0,0
"25025092300",2017,19,0,1,2,14,2,15,0,1,1,11,2,4,0,0,1,3,0,0,0.0526315789473684,0.105263157894737,0.736842105263158,0.105263157894737,0.789473684210526,0,0.0666666666666667,0.0666666666666667,0.733333333333333,0.133333333333333,0.210526315789474,0,0,0.25,0.75,0
"25025092400",2017,33,0,0,10,14,9,22,0,0,8,8,6,11,0,0,2,6,3,0,0,0.303030303030303,0.424242424242424,0.272727272727273,0.666666666666667,0,0,0.363636363636364,0.363636363636364,0.272727272727273,0.333333333333333,0,0,0.181818181818182,0.545454545454545,0.272727272727273
"25025100100",2017,26,0,1,7,10,8,21,0,1,6,8,6,5,0,0,1,2,2,0,0.0384615384615385,0.269230769230769,0.384615384615385,0.307692307692308,0.807692307692308,0,0.0476190476190476,0.285714285714286,0.380952380952381,0.285714285714286,0.192307692307692,0,0,0.2,0.4,0.4
"25025100200",2017,28,0,1,10,12,5,21,0,0,7,9,5,7,0,1,3,3,0,0,0.0357142857142857,0.357142857142857,0.428571428571429,0.178571428571429,0.75,0,0,0.333333333333333,0.428571428571429,0.238095238095238,0.25,0,0.142857142857143,0.428571428571429,0.428571428571429,0
"25025100300",2017,30,0,0,10,15,5,28,0,0,10,14,4,2,0,0,0,1,1,0,0,0.333333333333333,0.5,0.166666666666667,0.933333333333333,0,0,0.357142857142857,0.5,0.142857142857143,0.0666666666666667,0,0,0,0.5,0.5
"25025100400",2017,49,0,0,2,28,19,33,0,0,1,20,12,16,0,0,1,8,7,0,0,0.0408163265306122,0.571428571428571,0.387755102040816,0.673469387755102,0,0,0.0303030303030303,0.606060606060606,0.363636363636364,0.326530612244898,0,0,0.0625,0.5,0.4375
"25025100500",2017,69,0,1,8,26,34,62,0,1,6,22,33,7,0,0,2,4,1,0,0.0144927536231884,0.115942028985507,0.376811594202899,0.492753623188406,0.898550724637681,0,0.0161290322580645,0.0967741935483871,0.354838709677419,0.532258064516129,0.101449275362319,0,0,0.285714285714286,0.571428571428571,0.142857142857143
"25025100601",2017,62,0,0,11,28,23,56,0,0,9,24,23,6,0,0,2,4,0,0,0,0.17741935483871,0.451612903225806,0.370967741935484,0.903225806451613,0,0,0.160714285714286,0.428571428571429,0.410714285714286,0.0967741935483871,0,0,0.333333333333333,0.666666666666667,0
"25025100603",2017,46,0,0,7,22,17,41,0,0,7,18,16,5,0,0,0,4,1,0,0,0.152173913043478,0.478260869565217,0.369565217391304,0.891304347826087,0,0,0.170731707317073,0.439024390243902,0.390243902439024,0.108695652173913,0,0,0,0.8,0.2
"25025100700",2017,59,0,0,4,26,29,54,0,0,4,22,28,5,0,0,0,4,1,0,0,0.0677966101694915,0.440677966101695,0.491525423728814,0.915254237288136,0,0,0.0740740740740741,0.407407407407407,0.518518518518518,0.0847457627118644,0,0,0,0.8,0.2
"25025100800",2017,74,0,0,14,27,33,65,0,0,11,24,30,9,0,0,3,3,3,0,0,0.189189189189189,0.364864864864865,0.445945945945946,0.878378378378378,0,0,0.169230769230769,0.369230769230769,0.461538461538462,0.121621621621622,0,0,0.333333333333333,0.333333333333333,0.333333333333333
"25025100900",2017,44,0,0,7,13,24,40,0,0,7,11,22,4,0,0,0,2,2,0,0,0.159090909090909,0.295454545454545,0.545454545454545,0.909090909090909,0,0,0.175,0.275,0.55,0.0909090909090909,0,0,0,0.5,0.5
"25025101001",2017,30,0,0,5,18,7,27,0,0,5,16,6,3,0,0,0,2,1,0,0,0.166666666666667,0.6,0.233333333333333,0.9,0,0,0.185185185185185,0.592592592592593,0.222222222222222,0.1,0,0,0,0.666666666666667,0.333333333333333
"25025101002",2017,24,0,0,2,17,5,22,0,0,2,16,4,2,0,0,0,1,1,0,0,0.0833333333333333,0.708333333333333,0.208333333333333,0.916666666666667,0,0,0.0909090909090909,0.727272727272727,0.181818181818182,0.0833333333333333,0,0,0,0.5,0.5
"25025101101",2017,32,0,0,15,14,3,22,0,0,8,11,3,10,0,0,7,3,0,0,0,0.46875,0.4375,0.09375,0.6875,0,0,0.363636363636364,0.5,0.136363636363636,0.3125,0,0,0.7,0.3,0
"25025101102",2017,27,0,1,7,14,5,19,0,0,5,11,3,8,0,1,2,3,2,0,0.037037037037037,0.259259259259259,0.518518518518518,0.185185185185185,0.703703703703704,0,0,0.263157894736842,0.578947368421053,0.157894736842105,0.296296296296296,0,0.125,0.25,0.375,0.25
"25025110103",2017,53,1,1,10,15,26,50,1,1,9,13,26,3,0,0,1,2,0,0.0188679245283019,0.0188679245283019,0.188679245283019,0.283018867924528,0.490566037735849,0.943396226415094,0.02,0.02,0.18,0.26,0.52,0.0566037735849057,0,0,0.333333333333333,0.666666666666667,0
"25025110201",2017,17,0,0,4,10,3,14,0,0,2,9,3,3,0,0,2,1,0,0,0,0.235294117647059,0.588235294117647,0.176470588235294,0.823529411764706,0,0,0.142857142857143,0.642857142857143,0.214285714285714,0.176470588235294,0,0,0.666666666666667,0.333333333333333,0
"25025110301",2017,32,0,0,5,10,17,32,0,0,5,10,17,0,0,0,0,0,0,0,0,0.15625,0.3125,0.53125,1,0,0,0.15625,0.3125,0.53125,0,0,0,0,0,0
"25025110401",2017,53,0,0,20,15,18,45,0,0,17,12,16,8,0,0,3,3,2,0,0,0.377358490566038,0.283018867924528,0.339622641509434,0.849056603773585,0,0,0.377777777777778,0.266666666666667,0.355555555555556,0.150943396226415,0,0,0.375,0.375,0.25
"25025110403",2017,47,0,0,10,17,20,44,0,0,10,16,18,3,0,0,0,1,2,0,0,0.212765957446809,0.361702127659574,0.425531914893617,0.936170212765957,0,0,0.227272727272727,0.363636363636364,0.409090909090909,0.0638297872340425,0,0,0,0.333333333333333,0.666666666666667
"25025110501",2017,50,0,0,4,17,29,49,0,0,4,17,28,1,0,0,0,0,1,0,0,0.08,0.34,0.58,0.98,0,0,0.0816326530612245,0.346938775510204,0.571428571428571,0.02,0,0,0,0,1
"25025110502",2017,42,0,1,7,13,21,38,0,1,5,12,20,4,0,0,2,1,1,0,0.0238095238095238,0.166666666666667,0.30952380952381,0.5,0.904761904761905,0,0.0263157894736842,0.131578947368421,0.315789473684211,0.526315789473684,0.0952380952380952,0,0,0.5,0.25,0.25
"25025110601",2017,33,0,0,1,6,26,33,0,0,1,6,26,0,0,0,0,0,0,0,0,0.0303030303030303,0.181818181818182,0.787878787878788,1,0,0,0.0303030303030303,0.181818181818182,0.787878787878788,0,0,0,0,0,0
"25025110607",2017,70,0,1,7,23,39,66,0,1,5,23,37,4,0,0,2,0,2,0,0.0142857142857143,0.1,0.328571428571429,0.557142857142857,0.942857142857143,0,0.0151515151515152,0.0757575757575758,0.348484848484849,0.560606060606061,0.0571428571428571,0,0,0.5,0,0.5
"25025120103",2017,32,0,0,0,0,32,31,0,0,0,0,31,1,0,0,0,0,1,0,0,0,0,1,0.96875,0,0,0,0,1,0.03125,0,0,0,0,1
"25025120104",2017,48,0,0,9,13,26,45,0,0,9,12,24,3,0,0,0,1,2,0,0,0.1875,0.270833333333333,0.541666666666667,0.9375,0,0,0.2,0.266666666666667,0.533333333333333,0.0625,0,0,0,0.333333333333333,0.666666666666667
"25025120105",2017,21,0,0,1,0,20,19,0,0,0,0,19,2,0,0,1,0,1,0,0,0.0476190476190476,0,0.952380952380952,0.904761904761905,0,0,0,0,1,0.0952380952380952,0,0,0.5,0,0.5
"25025120201",2017,70,0,0,11,28,31,68,0,0,11,27,30,2,0,0,0,1,1,0,0,0.157142857142857,0.4,0.442857142857143,0.971428571428571,0,0,0.161764705882353,0.397058823529412,0.441176470588235,0.0285714285714286,0,0,0,0.5,0.5
"25025120301",2017,69,0,0,12,21,36,62,0,0,10,21,31,7,0,0,2,0,5,0,0,0.173913043478261,0.304347826086957,0.521739130434783,0.898550724637681,0,0,0.161290322580645,0.338709677419355,0.5,0.101449275362319,0,0,0.285714285714286,0,0.714285714285714
"25025120400",2017,73,0,2,1,17,53,72,0,2,1,17,52,1,0,0,0,0,1,0,0.0273972602739726,0.0136986301369863,0.232876712328767,0.726027397260274,0.986301369863014,0,0.0277777777777778,0.0138888888888889,0.236111111111111,0.722222222222222,0.0136986301369863,0,0,0,0,1
"25025120500",2017,34,0,0,4,6,24,32,0,0,3,6,23,2,0,0,1,0,1,0,0,0.117647058823529,0.176470588235294,0.705882352941177,0.941176470588235,0,0,0.09375,0.1875,0.71875,0.0588235294117647,0,0,0.5,0,0.5
"25025120600",2017,36,0,0,2,7,27,36,0,0,2,7,27,0,0,0,0,0,0,0,0,0.0555555555555556,0.194444444444444,0.75,1,0,0,0.0555555555555556,0.194444444444444,0.75,0,0,0,0,0,0
"25025120700",2017,23,0,0,3,9,11,23,0,0,3,9,11,0,0,0,0,0,0,0,0,0.130434782608696,0.391304347826087,0.478260869565217,1,0,0,0.130434782608696,0.391304347826087,0.478260869565217,0,0,0,0,0,0
"25025130100",2017,91,0,1,17,23,50,86,0,0,16,21,49,5,0,1,1,2,1,0,0.010989010989011,0.186813186813187,0.252747252747253,0.549450549450549,0.945054945054945,0,0,0.186046511627907,0.244186046511628,0.569767441860465,0.0549450549450549,0,0.2,0.2,0.4,0.2
"25025130200",2017,67,0,1,5,14,47,64,0,1,4,14,45,3,0,0,1,0,2,0,0.0149253731343284,0.0746268656716418,0.208955223880597,0.701492537313433,0.955223880597015,0,0.015625,0.0625,0.21875,0.703125,0.0447761194029851,0,0,0.333333333333333,0,0.666666666666667
"25025130300",2017,64,0,0,2,17,45,60,0,0,2,16,42,4,0,0,0,1,3,0,0,0.03125,0.265625,0.703125,0.9375,0,0,0.0333333333333333,0.266666666666667,0.7,0.0625,0,0,0,0.25,0.75
"25025130402",2017,69,0,1,13,22,33,67,0,0,13,22,32,2,0,1,0,0,1,0,0.0144927536231884,0.188405797101449,0.318840579710145,0.478260869565217,0.971014492753623,0,0,0.194029850746269,0.328358208955224,0.477611940298507,0.0289855072463768,0,0.5,0,0,0.5
"25025130404",2017,30,0,0,7,14,9,29,0,0,7,13,9,1,0,0,0,1,0,0,0,0.233333333333333,0.466666666666667,0.3,0.966666666666667,0,0,0.241379310344828,0.448275862068966,0.310344827586207,0.0333333333333333,0,0,0,1,0
"25025130406",2017,35,0,0,7,14,14,29,0,0,5,11,13,6,0,0,2,3,1,0,0,0.2,0.4,0.4,0.828571428571429,0,0,0.172413793103448,0.379310344827586,0.448275862068966,0.171428571428571,0,0,0.333333333333333,0.5,0.166666666666667
"25025140102",2017,52,0,0,13,25,14,46,0,0,11,21,14,6,0,0,2,4,0,0,0,0.25,0.480769230769231,0.269230769230769,0.884615384615385,0,0,0.239130434782609,0.456521739130435,0.304347826086957,0.115384615384615,0,0,0.333333333333333,0.666666666666667,0
"25025140105",2017,40,0,1,10,17,12,38,0,1,9,16,12,2,0,0,1,1,0,0,0.025,0.25,0.425,0.3,0.95,0,0.0263157894736842,0.236842105263158,0.421052631578947,0.315789473684211,0.05,0,0,0.5,0.5,0
"25025140106",2017,5,0,0,1,3,1,4,0,0,1,2,1,1,0,0,0,1,0,0,0,0.2,0.6,0.2,0.8,0,0,0.25,0.5,0.25,0.2,0,0,0,1,0
"25025140107",2017,25,0,0,6,11,8,21,0,0,5,9,7,4,0,0,1,2,1,0,0,0.24,0.44,0.32,0.84,0,0,0.238095238095238,0.428571428571429,0.333333333333333,0.16,0,0,0.25,0.5,0.25
"25025140201",2017,19,0,0,4,6,9,16,0,0,4,5,7,3,0,0,0,1,2,0,0,0.210526315789474,0.315789473684211,0.473684210526316,0.842105263157895,0,0,0.25,0.3125,0.4375,0.157894736842105,0,0,0,0.333333333333333,0.666666666666667
"25025140202",2017,45,0,1,5,19,20,42,0,1,5,18,18,3,0,0,0,1,2,0,0.0222222222222222,0.111111111111111,0.422222222222222,0.444444444444444,0.933333333333333,0,0.0238095238095238,0.119047619047619,0.428571428571429,0.428571428571429,0.0666666666666667,0,0,0,0.333333333333333,0.666666666666667
"25025140300",2017,40,0,0,10,23,7,33,0,0,8,18,7,7,0,0,2,5,0,0,0,0.25,0.575,0.175,0.825,0,0,0.242424242424242,0.545454545454545,0.212121212121212,0.175,0,0,0.285714285714286,0.714285714285714,0
"25025140400",2017,77,0,1,24,32,20,58,0,1,15,24,18,19,0,0,9,8,2,0,0.012987012987013,0.311688311688312,0.415584415584416,0.25974025974026,0.753246753246753,0,0.0172413793103448,0.258620689655172,0.413793103448276,0.310344827586207,0.246753246753247,0,0,0.473684210526316,0.421052631578947,0.105263157894737
"25025160101",2017,57,0,1,15,24,17,51,0,1,12,21,17,6,0,0,3,3,0,0,0.0175438596491228,0.263157894736842,0.421052631578947,0.298245614035088,0.894736842105263,0,0.0196078431372549,0.235294117647059,0.411764705882353,0.333333333333333,0.105263157894737,0,0,0.5,0.5,0
"25025160200",2017,18,0,0,3,10,5,17,0,0,2,10,5,1,0,0,1,0,0,0,0,0.166666666666667,0.555555555555556,0.277777777777778,0.944444444444444,0,0,0.117647058823529,0.588235294117647,0.294117647058824,0.0555555555555556,0,0,1,0,0
"25025160300",2017,43,0,0,7,19,17,42,0,0,6,19,17,1,0,0,1,0,0,0,0,0.162790697674419,0.441860465116279,0.395348837209302,0.976744186046512,0,0,0.142857142857143,0.452380952380952,0.404761904761905,0.0232558139534884,0,0,1,0,0
"25025160400",2017,16,0,0,2,4,10,15,0,0,2,4,9,1,0,0,0,0,1,0,0,0.125,0.25,0.625,0.9375,0,0,0.133333333333333,0.266666666666667,0.6,0.0625,0,0,0,0,1
"25025160501",2017,36,0,0,11,9,16,33,0,0,11,8,14,3,0,0,0,1,2,0,0,0.305555555555556,0.25,0.444444444444444,0.916666666666667,0,0,0.333333333333333,0.242424242424242,0.424242424242424,0.0833333333333333,0,0,0,0.333333333333333,0.666666666666667
"25025160502",2017,67,0,3,13,36,15,60,0,3,12,30,15,7,0,0,1,6,0,0,0.0447761194029851,0.194029850746269,0.537313432835821,0.223880597014925,0.895522388059702,0,0.05,0.2,0.5,0.25,0.104477611940299,0,0,0.142857142857143,0.857142857142857,0
"25025160601",2017,46,0,1,12,17,16,39,0,0,8,17,14,7,0,1,4,0,2,0,0.0217391304347826,0.260869565217391,0.369565217391304,0.347826086956522,0.847826086956522,0,0,0.205128205128205,0.435897435897436,0.358974358974359,0.152173913043478,0,0.142857142857143,0.571428571428571,0,0.285714285714286
"25025160602",2017,34,0,1,9,19,5,29,0,0,9,17,3,5,0,1,0,2,2,0,0.0294117647058824,0.264705882352941,0.558823529411765,0.147058823529412,0.852941176470588,0,0,0.310344827586207,0.586206896551724,0.103448275862069,0.147058823529412,0,0.2,0,0.4,0.4
"25025170100",2017,85,0,1,20,57,7,73,0,0,17,50,6,12,0,1,3,7,1,0,0.0117647058823529,0.235294117647059,0.670588235294118,0.0823529411764706,0.858823529411765,0,0,0.232876712328767,0.684931506849315,0.0821917808219178,0.141176470588235,0,0.0833333333333333,0.25,0.583333333333333,0.0833333333333333
"25025170200",2017,38,0,0,7,23,8,34,0,0,7,19,8,4,0,0,0,4,0,0,0,0.184210526315789,0.605263157894737,0.210526315789474,0.894736842105263,0,0,0.205882352941176,0.558823529411765,0.235294117647059,0.105263157894737,0,0,0,1,0
"25025170300",2017,121,0,0,31,66,24,102,0,0,24,58,20,19,0,0,7,8,4,0,0,0.256198347107438,0.545454545454545,0.198347107438017,0.84297520661157,0,0,0.235294117647059,0.568627450980392,0.196078431372549,0.15702479338843,0,0,0.368421052631579,0.421052631578947,0.210526315789474
"25025170400",2017,64,0,0,26,27,11,55,0,0,21,24,10,9,0,0,5,3,1,0,0,0.40625,0.421875,0.171875,0.859375,0,0,0.381818181818182,0.436363636363636,0.181818181818182,0.140625,0,0,0.555555555555556,0.333333333333333,0.111111111111111
"25025170501",2017,54,0,0,26,14,14,44,0,0,21,13,10,10,0,0,5,1,4,0,0,0.481481481481481,0.259259259259259,0.259259259259259,0.814814814814815,0,0,0.477272727272727,0.295454545454545,0.227272727272727,0.185185185185185,0,0,0.5,0.1,0.4
"25025170502",2017,33,0,0,11,12,10,31,0,0,10,11,10,2,0,0,1,1,0,0,0,0.333333333333333,0.363636363636364,0.303030303030303,0.939393939393939,0,0,0.32258064516129,0.354838709677419,0.32258064516129,0.0606060606060606,0,0,0.5,0.5,0
"25025170601",2017,69,0,1,24,32,12,57,0,1,21,26,9,12,0,0,3,6,3,0,0.0144927536231884,0.347826086956522,0.463768115942029,0.173913043478261,0.826086956521739,0,0.0175438596491228,0.368421052631579,0.456140350877193,0.157894736842105,0.173913043478261,0,0,0.25,0.5,0.25
"25025170701",2017,25,0,0,11,10,4,22,0,0,9,9,4,3,0,0,2,1,0,0,0,0.44,0.4,0.16,0.88,0,0,0.409090909090909,0.409090909090909,0.181818181818182,0.12,0,0,0.666666666666667,0.333333333333333,0
"25025170702",2017,47,0,0,17,25,5,36,0,0,14,17,5,11,0,0,3,8,0,0,0,0.361702127659574,0.531914893617021,0.106382978723404,0.765957446808511,0,0,0.388888888888889,0.472222222222222,0.138888888888889,0.234042553191489,0,0,0.272727272727273,0.727272727272727,0
"25025170800",2017,45,0,0,13,24,8,38,0,0,10,20,8,7,0,0,3,4,0,0,0,0.288888888888889,0.533333333333333,0.177777777777778,0.844444444444444,0,0,0.263157894736842,0.526315789473684,0.210526315789474,0.155555555555556,0,0,0.428571428571429,0.571428571428571,0
"25025180101",2017,66,0,0,24,21,21,58,0,0,20,18,20,8,0,0,4,3,1,0,0,0.363636363636364,0.318181818181818,0.318181818181818,0.878787878787879,0,0,0.344827586206897,0.310344827586207,0.344827586206897,0.121212121212121,0,0,0.5,0.375,0.125
"25025180200",2017,47,0,1,7,18,21,42,0,0,7,17,18,5,0,1,0,1,3,0,0.0212765957446809,0.148936170212766,0.382978723404255,0.446808510638298,0.893617021276596,0,0,0.166666666666667,0.404761904761905,0.428571428571429,0.106382978723404,0,0.2,0,0.2,0.6
"25025180301",2017,42,0,0,5,14,23,41,0,0,4,14,23,1,0,0,1,0,0,0,0,0.119047619047619,0.333333333333333,0.547619047619048,0.976190476190476,0,0,0.0975609756097561,0.341463414634146,0.560975609756098,0.0238095238095238,0,0,1,0,0
"25025180400",2017,20,0,0,3,9,8,19,0,0,3,8,8,1,0,0,0,1,0,0,0,0.15,0.45,0.4,0.95,0,0,0.157894736842105,0.421052631578947,0.421052631578947,0.05,0,0,0,1,0
"25025180500",2017,81,0,2,16,34,29,77,0,1,16,32,28,4,0,1,0,2,1,0,0.0246913580246914,0.197530864197531,0.419753086419753,0.358024691358025,0.950617283950617,0,0.012987012987013,0.207792207792208,0.415584415584416,0.363636363636364,0.0493827160493827,0,0.25,0,0.5,0.25
"25025980700",2017,2,0,0,1,1,0,2,0,0,1,1,0,0,0,0,0,0,0,0,0,0.5,0.5,0,1,0,0,0.5,0.5,0,0,0,0,0,0,0
"25025981100",2017,3,0,0,2,1,0,3,0,0,2,1,0,0,0,0,0,0,0,0,0,0.666666666666667,0.333333333333333,0,1,0,0,0.666666666666667,0.333333333333333,0,0,0,0,0,0,0
"25025981202",2017,1,0,0,1,0,0,1,0,0,1,0,0,0,0,0,0,0,0,0,0,1,0,0,1,0,0,1,0,0,0,0,0,0,0,0
"25025981300",2017,26,0,0,3,9,14,26,0,0,3,9,14,0,0,0,0,0,0,0,0,0.115384615384615,0.346153846153846,0.538461538461538,1,0,0,0.115384615384615,0.346153846153846,0.538461538461538,0,0,0,0,0,0
"25025981800",2017,1,0,0,0,0,1,1,0,0,0,0,1,0,0,0,0,0,0,0,0,0,0,1,1,0,0,0,0,1,0,0,0,0,0,0
"25027700100",2017,124,0,2,51,54,17,111,0,2,44,49,16,13,0,0,7,5,1,0,0.0161290322580645,0.411290322580645,0.435483870967742,0.137096774193548,0.895161290322581,0,0.018018018018018,0.396396396396396,0.441441441441441,0.144144144144144,0.104838709677419,0,0,0.538461538461538,0.384615384615385,0.0769230769230769
"25027701100",2017,137,0,9,86,32,10,122,0,7,78,27,10,15,0,2,8,5,0,0,0.0656934306569343,0.627737226277372,0.233576642335766,0.072992700729927,0.89051094890511,0,0.0573770491803279,0.639344262295082,0.221311475409836,0.0819672131147541,0.109489051094891,0,0.133333333333333,0.533333333333333,0.333333333333333,0
"25027702200",2017,49,0,5,26,16,2,40,0,2,22,15,1,9,0,3,4,1,1,0,0.102040816326531,0.530612244897959,0.326530612244898,0.0408163265306122,0.816326530612245,0,0.05,0.55,0.375,0.025,0.183673469387755,0,0.333333333333333,0.444444444444444,0.111111111111111,0.111111111111111
"25027703100",2017,84,0,21,44,15,4,74,0,17,39,14,4,10,0,4,5,1,0,0,0.25,0.523809523809524,0.178571428571429,0.0476190476190476,0.880952380952381,0,0.22972972972973,0.527027027027027,0.189189189189189,0.0540540540540541,0.119047619047619,0,0.4,0.5,0.1,0
"25027703200",2017,65,0,7,43,14,1,59,0,6,39,13,1,6,0,1,4,1,0,0,0.107692307692308,0.661538461538462,0.215384615384615,0.0153846153846154,0.907692307692308,0,0.101694915254237,0.661016949152542,0.220338983050847,0.0169491525423729,0.0923076923076923,0,0.166666666666667,0.666666666666667,0.166666666666667,0
"25027703300",2017,63,0,5,43,11,4,51,0,4,34,10,3,12,0,1,9,1,1,0,0.0793650793650794,0.682539682539683,0.174603174603175,0.0634920634920635,0.80952380952381,0,0.0784313725490196,0.666666666666667,0.196078431372549,0.0588235294117647,0.19047619047619,0,0.0833333333333333,0.75,0.0833333333333333,0.0833333333333333
"25027704200",2017,40,0,1,13,16,10,38,0,1,13,15,9,2,0,0,0,1,1,0,0.025,0.325,0.4,0.25,0.95,0,0.0263157894736842,0.342105263157895,0.394736842105263,0.236842105263158,0.05,0,0,0,0.5,0.5
"25027705100",2017,106,0,7,43,45,11,94,0,4,39,41,10,12,0,3,4,4,1,0,0.0660377358490566,0.405660377358491,0.424528301886792,0.10377358490566,0.886792452830189,0,0.0425531914893617,0.414893617021277,0.436170212765957,0.106382978723404,0.113207547169811,0,0.25,0.333333333333333,0.333333333333333,0.0833333333333333
"25027706100",2017,75,0,4,32,32,7,67,0,3,28,31,5,8,0,1,4,1,2,0,0.0533333333333333,0.426666666666667,0.426666666666667,0.0933333333333333,0.893333333333333,0,0.0447761194029851,0.417910447761194,0.462686567164179,0.0746268656716418,0.106666666666667,0,0.125,0.5,0.125,0.25
"25027707100",2017,50,1,3,31,9,6,42,1,1,27,8,5,8,0,2,4,1,1,0.02,0.06,0.62,0.18,0.12,0.84,0.0238095238095238,0.0238095238095238,0.642857142857143,0.19047619047619,0.119047619047619,0.16,0,0.25,0.5,0.125,0.125
"25027707200",2017,14,0,2,11,1,0,13,0,2,10,1,0,1,0,0,1,0,0,0,0.142857142857143,0.785714285714286,0.0714285714285714,0,0.928571428571429,0,0.153846153846154,0.769230769230769,0.0769230769230769,0,0.0714285714285714,0,0,1,0,0
"25027707300",2017,38,0,6,22,6,4,32,0,5,19,4,4,6,0,1,3,2,0,0,0.157894736842105,0.578947368421053,0.157894736842105,0.105263157894737,0.842105263157895,0,0.15625,0.59375,0.125,0.125,0.157894736842105,0,0.166666666666667,0.5,0.333333333333333,0
"25027707400",2017,114,0,9,72,27,6,102,0,7,64,25,6,12,0,2,8,2,0,0,0.0789473684210526,0.631578947368421,0.236842105263158,0.0526315789473684,0.894736842105263,0,0.0686274509803922,0.627450980392157,0.245098039215686,0.0588235294117647,0.105263157894737,0,0.166666666666667,0.666666666666667,0.166666666666667,0
"25027707500",2017,84,0,3,49,25,7,71,0,2,42,20,7,13,0,1,7,5,0,0,0.0357142857142857,0.583333333333333,0.297619047619048,0.0833333333333333,0.845238095238095,0,0.028169014084507,0.591549295774648,0.28169014084507,0.0985915492957746,0.154761904761905,0,0.0769230769230769,0.538461538461538,0.384615384615385,0
"25027708100",2017,141,0,3,39,52,47,127,0,2,34,47,44,14,0,1,5,5,3,0,0.0212765957446809,0.276595744680851,0.368794326241135,0.333333333333333,0.900709219858156,0,0.015748031496063,0.267716535433071,0.37007874015748,0.346456692913386,0.099290780141844,0,0.0714285714285714,0.357142857142857,0.357142857142857,0.214285714285714
"25027709100",2017,82,0,0,26,27,29,77,0,0,23,25,29,5,0,0,3,2,0,0,0,0.317073170731707,0.329268292682927,0.353658536585366,0.939024390243902,0,0,0.298701298701299,0.324675324675325,0.376623376623377,0.0609756097560976,0,0,0.6,0.4,0
"25027709201",2017,156,0,10,74,49,23,135,0,5,63,45,22,21,0,5,11,4,1,0,0.0641025641025641,0.474358974358974,0.314102564102564,0.147435897435897,0.865384615384615,0,0.037037037037037,0.466666666666667,0.333333333333333,0.162962962962963,0.134615384615385,0,0.238095238095238,0.523809523809524,0.19047619047619,0.0476190476190476
"25027709202",2017,136,0,9,75,40,12,118,0,8,64,34,12,18,0,1,11,6,0,0,0.0661764705882353,0.551470588235294,0.294117647058824,0.0882352941176471,0.867647058823529,0,0.0677966101694915,0.542372881355932,0.288135593220339,0.101694915254237,0.132352941176471,0,0.0555555555555556,0.611111111111111,0.333333333333333,0
"25027709400",2017,45,0,5,25,9,6,37,0,3,21,8,5,8,0,2,4,1,1,0,0.111111111111111,0.555555555555556,0.2,0.133333333333333,0.822222222222222,0,0.0810810810810811,0.567567567567568,0.216216216216216,0.135135135135135,0.177777777777778,0,0.25,0.5,0.125,0.125
"25027709501",2017,32,0,0,7,16,9,28,0,0,5,14,9,4,0,0,2,2,0,0,0,0.21875,0.5,0.28125,0.875,0,0,0.178571428571429,0.5,0.321428571428571,0.125,0,0,0.5,0.5,0
"25027709502",2017,106,0,2,53,36,15,96,0,1,48,32,15,10,0,1,5,4,0,0,0.0188679245283019,0.5,0.339622641509434,0.141509433962264,0.905660377358491,0,0.0104166666666667,0.5,0.333333333333333,0.15625,0.0943396226415094,0,0.1,0.5,0.4,0
"25027709600",2017,24,0,1,13,9,1,19,0,0,12,6,1,5,0,1,1,3,0,0,0.0416666666666667,0.541666666666667,0.375,0.0416666666666667,0.791666666666667,0,0,0.631578947368421,0.315789473684211,0.0526315789473684,0.208333333333333,0,0.2,0.2,0.6,0
"25027709701",2017,77,0,3,41,26,7,66,0,2,34,23,7,11,0,1,7,3,0,0,0.038961038961039,0.532467532467532,0.337662337662338,0.0909090909090909,0.857142857142857,0,0.0303030303030303,0.515151515151515,0.348484848484849,0.106060606060606,0.142857142857143,0,0.0909090909090909,0.636363636363636,0.272727272727273,0
"25027709702",2017,40,0,1,21,10,8,36,0,1,17,10,8,4,0,0,4,0,0,0,0.025,0.525,0.25,0.2,0.9,0,0.0277777777777778,0.472222222222222,0.277777777777778,0.222222222222222,0.1,0,0,1,0,0
"25027710100",2017,46,0,5,29,9,3,43,0,4,28,8,3,3,0,1,1,1,0,0,0.108695652173913,0.630434782608696,0.195652173913043,0.0652173913043478,0.934782608695652,0,0.0930232558139535,0.651162790697674,0.186046511627907,0.0697674418604651,0.0652173913043478,0,0.333333333333333,0.333333333333333,0.333333333333333,0
"25027710200",2017,150,0,4,90,37,19,135,0,4,84,30,17,15,0,0,6,7,2,0,0.0266666666666667,0.6,0.246666666666667,0.126666666666667,0.9,0,0.0296296296296296,0.622222222222222,0.222222222222222,0.125925925925926,0.1,0,0,0.4,0.466666666666667,0.133333333333333
"25027710300",2017,65,0,1,44,18,2,58,0,1,38,17,2,7,0,0,6,1,0,0,0.0153846153846154,0.676923076923077,0.276923076923077,0.0307692307692308,0.892307692307692,0,0.0172413793103448,0.655172413793103,0.293103448275862,0.0344827586206897,0.107692307692308,0,0,0.857142857142857,0.142857142857143,0
"25027710400",2017,37,0,2,24,10,1,35,0,2,23,9,1,2,0,0,1,1,0,0,0.0540540540540541,0.648648648648649,0.27027027027027,0.027027027027027,0.945945945945946,0,0.0571428571428571,0.657142857142857,0.257142857142857,0.0285714285714286,0.0540540540540541,0,0,0.5,0.5,0
"25027710500",2017,33,0,4,18,7,4,28,0,3,16,5,4,5,0,1,2,2,0,0,0.121212121212121,0.545454545454545,0.212121212121212,0.121212121212121,0.848484848484849,0,0.107142857142857,0.571428571428571,0.178571428571429,0.142857142857143,0.151515151515152,0,0.2,0.4,0.4,0
"25027710600",2017,108,0,12,69,20,7,89,0,8,56,18,7,19,0,4,13,2,0,0,0.111111111111111,0.638888888888889,0.185185185185185,0.0648148148148148,0.824074074074074,0,0.0898876404494382,0.629213483146067,0.202247191011236,0.0786516853932584,0.175925925925926,0,0.210526315789474,0.684210526315789,0.105263157894737,0
"25027710700",2017,4,0,0,4,0,0,2,0,0,2,0,0,2,0,0,2,0,0,0,0,1,0,0,0.5,0,0,1,0,0,0.5,0,0,1,0,0
"25027710800",2017,50,0,1,28,11,10,40,0,0,24,8,8,10,0,1,4,3,2,0,0.02,0.56,0.22,0.2,0.8,0,0,0.6,0.2,0.2,0.2,0,0.1,0.4,0.3,0.2
"25027711000",2017,26,0,1,17,6,2,19,0,1,10,6,2,7,0,0,7,0,0,0,0.0384615384615385,0.653846153846154,0.230769230769231,0.0769230769230769,0.730769230769231,0,0.0526315789473684,0.526315789473684,0.315789473684211,0.105263157894737,0.269230769230769,0,0,1,0,0
"25027711100",2017,77,0,7,37,28,5,69,0,6,32,26,5,8,0,1,5,2,0,0,0.0909090909090909,0.480519480519481,0.363636363636364,0.0649350649350649,0.896103896103896,0,0.0869565217391304,0.463768115942029,0.376811594202899,0.072463768115942,0.103896103896104,0,0.125,0.625,0.25,0
"25027712101",2017,147,0,5,48,57,37,132,0,4,42,53,33,15,0,1,6,4,4,0,0.0340136054421769,0.326530612244898,0.387755102040816,0.251700680272109,0.897959183673469,0,0.0303030303030303,0.318181818181818,0.401515151515151,0.25,0.102040816326531,0,0.0666666666666667,0.4,0.266666666666667,0.266666666666667
"25027712102",2017,77,1,1,17,29,29,65,0,0,12,26,27,12,1,1,5,3,2,0.012987012987013,0.012987012987013,0.220779220779221,0.376623376623377,0.376623376623377,0.844155844155844,0,0,0.184615384615385,0.4,0.415384615384615,0.155844155844156,0.0833333333333333,0.0833333333333333,0.416666666666667,0.25,0.166666666666667
"25027713100",2017,98,0,0,19,42,37,84,0,0,13,35,36,14,0,0,6,7,1,0,0,0.193877551020408,0.428571428571429,0.377551020408163,0.857142857142857,0,0,0.154761904761905,0.416666666666667,0.428571428571429,0.142857142857143,0,0,0.428571428571429,0.5,0.0714285714285714
"25027715100",2017,110,0,0,7,16,87,104,0,0,6,16,82,6,0,0,1,0,5,0,0,0.0636363636363636,0.145454545454545,0.790909090909091,0.945454545454545,0,0,0.0576923076923077,0.153846153846154,0.788461538461538,0.0545454545454545,0,0,0.166666666666667,0,0.833333333333333
"25027716100",2017,131,0,7,52,46,26,109,0,5,41,39,24,22,0,2,11,7,2,0,0.0534351145038168,0.396946564885496,0.351145038167939,0.198473282442748,0.83206106870229,0,0.0458715596330275,0.376146788990826,0.357798165137615,0.220183486238532,0.16793893129771,0,0.0909090909090909,0.5,0.318181818181818,0.0909090909090909
"25027716200",2017,45,0,4,24,14,3,38,0,3,22,10,3,7,0,1,2,4,0,0,0.0888888888888889,0.533333333333333,0.311111111111111,0.0666666666666667,0.844444444444444,0,0.0789473684210526,0.578947368421053,0.263157894736842,0.0789473684210526,0.155555555555556,0,0.142857142857143,0.285714285714286,0.571428571428571,0
"25027716300",2017,44,0,1,21,16,6,40,0,1,21,13,5,4,0,0,0,3,1,0,0.0227272727272727,0.477272727272727,0.363636363636364,0.136363636363636,0.909090909090909,0,0.025,0.525,0.325,0.125,0.0909090909090909,0,0,0,0.75,0.25
"25027717100",2017,62,0,0,8,24,30,59,0,0,8,22,29,3,0,0,0,2,1,0,0,0.129032258064516,0.387096774193548,0.483870967741935,0.951612903225806,0,0,0.135593220338983,0.372881355932203,0.491525423728814,0.0483870967741935,0,0,0,0.666666666666667,0.333333333333333
"25027718100",2017,97,0,1,15,33,48,83,0,1,10,31,41,14,0,0,5,2,7,0,0.0103092783505155,0.154639175257732,0.34020618556701,0.494845360824742,0.855670103092783,0,0.0120481927710843,0.120481927710843,0.373493975903614,0.493975903614458,0.144329896907216,0,0,0.357142857142857,0.142857142857143,0.5
"25027719100",2017,115,0,3,25,46,41,109,0,3,23,45,38,6,0,0,2,1,3,0,0.0260869565217391,0.217391304347826,0.4,0.356521739130435,0.947826086956522,0,0.0275229357798165,0.211009174311927,0.412844036697248,0.348623853211009,0.0521739130434783,0,0,0.333333333333333,0.166666666666667,0.5
"25027720100",2017,53,0,1,11,23,18,48,0,1,8,22,17,5,0,0,3,1,1,0,0.0188679245283019,0.207547169811321,0.433962264150943,0.339622641509434,0.905660377358491,0,0.0208333333333333,0.166666666666667,0.458333333333333,0.354166666666667,0.0943396226415094,0,0,0.6,0.2,0.2
"25027721101",2017,29,0,1,16,8,4,27,0,1,15,8,3,2,0,0,1,0,1,0,0.0344827586206897,0.551724137931034,0.275862068965517,0.137931034482759,0.931034482758621,0,0.037037037037037,0.555555555555556,0.296296296296296,0.111111111111111,0.0689655172413793,0,0,0.5,0,0.5
"25027721102",2017,159,0,5,45,69,40,151,0,5,40,68,38,8,0,0,5,1,2,0,0.0314465408805031,0.283018867924528,0.433962264150943,0.251572327044025,0.949685534591195,0,0.033112582781457,0.264900662251656,0.450331125827815,0.251655629139073,0.050314465408805,0,0,0.625,0.125,0.25
"25027722100",2017,87,0,10,43,25,9,77,0,8,39,22,8,10,0,2,4,3,1,0,0.114942528735632,0.494252873563218,0.28735632183908,0.103448275862069,0.885057471264368,0,0.103896103896104,0.506493506493506,0.285714285714286,0.103896103896104,0.114942528735632,0,0.2,0.4,0.3,0.1
"25027723100",2017,36,0,2,14,14,6,29,0,1,12,11,5,7,0,1,2,3,1,0,0.0555555555555556,0.388888888888889,0.388888888888889,0.166666666666667,0.805555555555556,0,0.0344827586206897,0.413793103448276,0.379310344827586,0.172413793103448,0.194444444444444,0,0.142857142857143,0.285714285714286,0.428571428571429,0.142857142857143
"25027724100",2017,40,0,1,18,12,9,38,0,1,18,12,7,2,0,0,0,0,2,0,0.025,0.45,0.3,0.225,0.95,0,0.0263157894736842,0.473684210526316,0.315789473684211,0.184210526315789,0.05,0,0,0,0,1
"25027725100",2017,69,0,6,30,21,12,59,0,5,26,16,12,10,0,1,4,5,0,0,0.0869565217391304,0.434782608695652,0.304347826086957,0.173913043478261,0.855072463768116,0,0.0847457627118644,0.440677966101695,0.271186440677966,0.203389830508475,0.144927536231884,0,0.1,0.4,0.5,0
"25027726100",2017,88,0,3,38,26,21,77,0,3,32,24,18,11,0,0,6,2,3,0,0.0340909090909091,0.431818181818182,0.295454545454545,0.238636363636364,0.875,0,0.038961038961039,0.415584415584416,0.311688311688312,0.233766233766234,0.125,0,0,0.545454545454545,0.181818181818182,0.272727272727273
"25027726200",2017,75,0,7,39,17,12,64,0,6,33,16,9,11,0,1,6,1,3,0,0.0933333333333333,0.52,0.226666666666667,0.16,0.853333333333333,0,0.09375,0.515625,0.25,0.140625,0.146666666666667,0,0.0909090909090909,0.545454545454545,0.0909090909090909,0.272727272727273
"25027727100",2017,81,0,1,25,33,22,75,0,0,23,32,20,6,0,1,2,1,2,0,0.0123456790123457,0.308641975308642,0.407407407407407,0.271604938271605,0.925925925925926,0,0,0.306666666666667,0.426666666666667,0.266666666666667,0.0740740740740741,0,0.166666666666667,0.333333333333333,0.166666666666667,0.333333333333333
"25027728100",2017,108,0,3,28,32,45,93,0,2,18,29,44,15,0,1,10,3,1,0,0.0277777777777778,0.259259259259259,0.296296296296296,0.416666666666667,0.861111111111111,0,0.021505376344086,0.193548387096774,0.311827956989247,0.473118279569892,0.138888888888889,0,0.0666666666666667,0.666666666666667,0.2,0.0666666666666667
"25027728200",2017,66,0,0,30,18,18,64,0,0,30,17,17,2,0,0,0,1,1,0,0,0.454545454545455,0.272727272727273,0.272727272727273,0.96969696969697,0,0,0.46875,0.265625,0.265625,0.0303030303030303,0,0,0,0.5,0.5
"25027728300",2017,87,0,1,23,37,26,80,0,1,19,35,25,7,0,0,4,2,1,0,0.0114942528735632,0.264367816091954,0.425287356321839,0.298850574712644,0.919540229885057,0,0.0125,0.2375,0.4375,0.3125,0.0804597701149425,0,0,0.571428571428571,0.285714285714286,0.142857142857143
"25027728400",2017,95,1,0,27,28,39,89,1,0,22,28,38,6,0,0,5,0,1,0.0105263157894737,0,0.284210526315789,0.294736842105263,0.410526315789474,0.936842105263158,0.0112359550561798,0,0.247191011235955,0.314606741573034,0.426966292134831,0.0631578947368421,0,0,0.833333333333333,0,0.166666666666667
"25027729100",2017,54,0,1,20,23,10,51,0,1,18,22,10,3,0,0,2,1,0,0,0.0185185185185185,0.37037037037037,0.425925925925926,0.185185185185185,0.944444444444444,0,0.0196078431372549,0.352941176470588,0.431372549019608,0.196078431372549,0.0555555555555556,0,0,0.666666666666667,0.333333333333333,0
"25027729200",2017,50,0,1,21,22,6,46,0,1,20,20,5,4,0,0,1,2,1,0,0.02,0.42,0.44,0.12,0.92,0,0.0217391304347826,0.434782608695652,0.434782608695652,0.108695652173913,0.08,0,0,0.25,0.5,0.25
"25027730100",2017,116,0,5,66,35,10,103,0,2,58,34,9,13,0,3,8,1,1,0,0.0431034482758621,0.568965517241379,0.301724137931034,0.0862068965517241,0.887931034482759,0,0.0194174757281553,0.563106796116505,0.330097087378641,0.087378640776699,0.112068965517241,0,0.230769230769231,0.615384615384615,0.0769230769230769,0.0769230769230769
"25027730200",2017,100,0,0,50,33,17,86,0,0,44,28,14,14,0,0,6,5,3,0,0,0.5,0.33,0.17,0.86,0,0,0.511627906976744,0.325581395348837,0.162790697674419,0.14,0,0,0.428571428571429,0.357142857142857,0.214285714285714
"25027730300",2017,73,0,1,41,21,10,66,0,1,37,18,10,7,0,0,4,3,0,0,0.0136986301369863,0.561643835616438,0.287671232876712,0.136986301369863,0.904109589041096,0,0.0151515151515152,0.560606060606061,0.272727272727273,0.151515151515152,0.0958904109589041,0,0,0.571428571428571,0.428571428571429,0
"25027730401",2017,64,0,1,37,17,9,57,0,1,33,15,8,7,0,0,4,2,1,0,0.015625,0.578125,0.265625,0.140625,0.890625,0,0.0175438596491228,0.578947368421053,0.263157894736842,0.140350877192982,0.109375,0,0,0.571428571428571,0.285714285714286,0.142857142857143
"25027730402",2017,24,1,0,13,8,2,20,0,0,12,7,1,4,1,0,1,1,1,0.0416666666666667,0,0.541666666666667,0.333333333333333,0.0833333333333333,0.833333333333333,0,0,0.6,0.35,0.05,0.166666666666667,0.25,0,0.25,0.25,0.25
"25027730500",2017,44,0,7,26,8,3,37,0,4,22,8,3,7,0,3,4,0,0,0,0.159090909090909,0.590909090909091,0.181818181818182,0.0681818181818182,0.840909090909091,0,0.108108108108108,0.594594594594595,0.216216216216216,0.0810810810810811,0.159090909090909,0,0.428571428571429,0.571428571428571,0,0
"25027730600",2017,101,0,1,34,34,32,95,0,0,32,32,31,6,0,1,2,2,1,0,0.0099009900990099,0.336633663366337,0.336633663366337,0.316831683168317,0.940594059405941,0,0,0.336842105263158,0.336842105263158,0.326315789473684,0.0594059405940594,0,0.166666666666667,0.333333333333333,0.333333333333333,0.166666666666667
"25027730700",2017,136,2,2,72,38,22,124,0,2,65,37,20,12,2,0,7,1,2,0.0147058823529412,0.0147058823529412,0.529411764705882,0.279411764705882,0.161764705882353,0.911764705882353,0,0.0161290322580645,0.524193548387097,0.298387096774194,0.161290322580645,0.0882352941176471,0.166666666666667,0,0.583333333333333,0.0833333333333333,0.166666666666667
"25027730801",2017,68,0,2,19,28,19,63,0,2,17,25,19,5,0,0,2,3,0,0,0.0294117647058824,0.279411764705882,0.411764705882353,0.279411764705882,0.926470588235294,0,0.0317460317460317,0.26984126984127,0.396825396825397,0.301587301587302,0.0735294117647059,0,0,0.4,0.6,0
"25027730802",2017,33,0,0,12,13,8,30,0,0,11,11,8,3,0,0,1,2,0,0,0,0.363636363636364,0.393939393939394,0.242424242424242,0.909090909090909,0,0,0.366666666666667,0.366666666666667,0.266666666666667,0.0909090909090909,0,0,0.333333333333333,0.666666666666667,0
"25027730901",2017,52,0,1,26,15,10,48,0,0,24,15,9,4,0,1,2,0,1,0,0.0192307692307692,0.5,0.288461538461538,0.192307692307692,0.923076923076923,0,0,0.5,0.3125,0.1875,0.0769230769230769,0,0.25,0.5,0,0.25
"25027730902",2017,45,0,0,24,18,3,41,0,0,21,17,3,4,0,0,3,1,0,0,0,0.533333333333333,0.4,0.0666666666666667,0.911111111111111,0,0,0.51219512195122,0.414634146341463,0.0731707317073171,0.0888888888888889,0,0,0.75,0.25,0
"25027731001",2017,36,2,1,22,8,3,29,1,1,18,7,2,7,1,0,4,1,1,0.0555555555555556,0.0277777777777778,0.611111111111111,0.222222222222222,0.0833333333333333,0.805555555555556,0.0344827586206897,0.0344827586206897,0.620689655172414,0.241379310344828,0.0689655172413793,0.194444444444444,0.142857142857143,0,0.571428571428571,0.142857142857143,0.142857142857143
"25027731002",2017,73,0,4,50,17,2,66,0,3,45,16,2,7,0,1,5,1,0,0,0.0547945205479452,0.684931506849315,0.232876712328767,0.0273972602739726,0.904109589041096,0,0.0454545454545455,0.681818181818182,0.242424242424242,0.0303030303030303,0.0958904109589041,0,0.142857142857143,0.714285714285714,0.142857142857143,0
"25027731101",2017,56,0,6,38,9,3,44,0,2,30,9,3,12,0,4,8,0,0,0,0.107142857142857,0.678571428571429,0.160714285714286,0.0535714285714286,0.785714285714286,0,0.0454545454545455,0.681818181818182,0.204545454545455,0.0681818181818182,0.214285714285714,0,0.333333333333333,0.666666666666667,0,0
"25027731102",2017,34,0,1,18,12,3,31,0,1,18,10,2,3,0,0,0,2,1,0,0.0294117647058824,0.529411764705882,0.352941176470588,0.0882352941176471,0.911764705882353,0,0.032258064516129,0.580645161290323,0.32258064516129,0.0645161290322581,0.0882352941176471,0,0,0,0.666666666666667,0.333333333333333
"25027731203",2017,15,1,0,6,4,4,12,0,0,5,3,4,3,1,0,1,1,0,0.0666666666666667,0,0.4,0.266666666666667,0.266666666666667,0.8,0,0,0.416666666666667,0.25,0.333333333333333,0.2,0.333333333333333,0,0.333333333333333,0.333333333333333,0
"25027731204",2017,9,0,0,4,2,3,9,0,0,4,2,3,0,0,0,0,0,0,0,0,0.444444444444444,0.222222222222222,0.333333333333333,1,0,0,0.444444444444444,0.222222222222222,0.333333333333333,0,0,0,0,0,0
"25027731300",2017,14,0,0,8,1,5,10,0,0,6,0,4,4,0,0,2,1,1,0,0,0.571428571428571,0.0714285714285714,0.357142857142857,0.714285714285714,0,0,0.6,0,0.4,0.285714285714286,0,0,0.5,0.25,0.25
"25027731400",2017,19,0,3,12,4,0,15,0,3,9,3,0,4,0,0,3,1,0,0,0.157894736842105,0.631578947368421,0.210526315789474,0,0.789473684210526,0,0.2,0.6,0.2,0,0.210526315789474,0,0,0.75,0.25,0
"25027731500",2017,19,0,2,12,4,1,14,0,1,9,4,0,5,0,1,3,0,1,0,0.105263157894737,0.631578947368421,0.210526315789474,0.0526315789473684,0.736842105263158,0,0.0714285714285714,0.642857142857143,0.285714285714286,0,0.263157894736842,0,0.2,0.6,0,0.2
"25027731600",2017,17,0,0,6,4,7,15,0,0,6,4,5,2,0,0,0,0,2,0,0,0.352941176470588,0.235294117647059,0.411764705882353,0.882352941176471,0,0,0.4,0.266666666666667,0.333333333333333,0.117647058823529,0,0,0,0,1
"25027731700",2017,17,0,0,7,2,8,14,0,0,6,2,6,3,0,0,1,0,2,0,0,0.411764705882353,0.117647058823529,0.470588235294118,0.823529411764706,0,0,0.428571428571429,0.142857142857143,0.428571428571429,0.176470588235294,0,0,0.333333333333333,0,0.666666666666667
"25027731800",2017,48,0,5,24,10,9,43,0,3,23,8,9,5,0,2,1,2,0,0,0.104166666666667,0.5,0.208333333333333,0.1875,0.895833333333333,0,0.0697674418604651,0.534883720930233,0.186046511627907,0.209302325581395,0.104166666666667,0,0.4,0.2,0.4,0
"25027731900",2017,49,0,0,18,23,8,38,0,0,13,18,7,11,0,0,5,5,1,0,0,0.36734693877551,0.469387755102041,0.163265306122449,0.775510204081633,0,0,0.342105263157895,0.473684210526316,0.184210526315789,0.224489795918367,0,0,0.454545454545455,0.454545454545455,0.0909090909090909
"25027732001",2017,2,0,0,2,0,0,2,0,0,2,0,0,0,0,0,0,0,0,0,0,1,0,0,1,0,0,1,0,0,0,0,0,0,0,0
"25027732002",2017,54,0,3,33,10,8,48,0,3,30,9,6,6,0,0,3,1,2,0,0.0555555555555556,0.611111111111111,0.185185185185185,0.148148148148148,0.888888888888889,0,0.0625,0.625,0.1875,0.125,0.111111111111111,0,0,0.5,0.166666666666667,0.333333333333333
"25027732201",2017,24,0,0,11,6,7,19,0,0,9,4,6,5,0,0,2,2,1,0,0,0.458333333333333,0.25,0.291666666666667,0.791666666666667,0,0,0.473684210526316,0.210526315789474,0.315789473684211,0.208333333333333,0,0,0.4,0.4,0.2
"25027732202",2017,45,0,0,25,12,8,38,0,0,21,11,6,7,0,0,4,1,2,0,0,0.555555555555556,0.266666666666667,0.177777777777778,0.844444444444444,0,0,0.552631578947368,0.289473684210526,0.157894736842105,0.155555555555556,0,0,0.571428571428571,0.142857142857143,0.285714285714286
"25027732203",2017,19,0,3,10,5,1,14,0,0,9,4,1,5,0,3,1,1,0,0,0.157894736842105,0.526315789473684,0.263157894736842,0.0526315789473684,0.736842105263158,0,0,0.642857142857143,0.285714285714286,0.0714285714285714,0.263157894736842,0,0.6,0.2,0.2,0
"25027732301",2017,89,1,2,53,26,7,81,0,2,49,23,7,8,1,0,4,3,0,0.0112359550561798,0.0224719101123595,0.595505617977528,0.292134831460674,0.0786516853932584,0.910112359550562,0,0.0246913580246914,0.604938271604938,0.283950617283951,0.0864197530864197,0.0898876404494382,0.125,0,0.5,0.375,0
"25027732302",2017,62,0,1,37,19,5,51,0,1,29,16,5,11,0,0,8,3,0,0,0.0161290322580645,0.596774193548387,0.306451612903226,0.0806451612903226,0.82258064516129,0,0.0196078431372549,0.568627450980392,0.313725490196078,0.0980392156862745,0.17741935483871,0,0,0.727272727272727,0.272727272727273,0
"25027732400",2017,70,0,3,48,12,7,59,0,3,38,12,6,11,0,0,10,0,1,0,0.0428571428571429,0.685714285714286,0.171428571428571,0.1,0.842857142857143,0,0.0508474576271186,0.644067796610169,0.203389830508475,0.101694915254237,0.157142857142857,0,0,0.909090909090909,0,0.0909090909090909
"25027732500",2017,18,0,1,9,5,3,13,0,1,6,4,2,5,0,0,3,1,1,0,0.0555555555555556,0.5,0.277777777777778,0.166666666666667,0.722222222222222,0,0.0769230769230769,0.461538461538462,0.307692307692308,0.153846153846154,0.277777777777778,0,0,0.6,0.2,0.2
"25027732600",2017,35,0,3,19,9,4,30,0,2,15,9,4,5,0,1,4,0,0,0,0.0857142857142857,0.542857142857143,0.257142857142857,0.114285714285714,0.857142857142857,0,0.0666666666666667,0.5,0.3,0.133333333333333,0.142857142857143,0,0.2,0.8,0,0
"25027732700",2017,28,0,2,15,8,3,25,0,2,14,6,3,3,0,0,1,2,0,0,0.0714285714285714,0.535714285714286,0.285714285714286,0.107142857142857,0.892857142857143,0,0.08,0.56,0.24,0.12,0.107142857142857,0,0,0.333333333333333,0.666666666666667,0
"25027732801",2017,89,2,3,47,25,12,77,0,3,41,23,10,12,2,0,6,2,2,0.0224719101123595,0.0337078651685393,0.528089887640449,0.280898876404494,0.134831460674157,0.865168539325843,0,0.038961038961039,0.532467532467532,0.298701298701299,0.12987012987013,0.134831460674157,0.166666666666667,0,0.5,0.166666666666667,0.166666666666667
"25027732802",2017,71,0,6,39,18,8,60,0,5,33,15,7,11,0,1,6,3,1,0,0.0845070422535211,0.549295774647887,0.253521126760563,0.112676056338028,0.845070422535211,0,0.0833333333333333,0.55,0.25,0.116666666666667,0.154929577464789,0,0.0909090909090909,0.545454545454545,0.272727272727273,0.0909090909090909
"25027732901",2017,94,1,4,59,24,6,75,0,2,47,20,6,19,1,2,12,4,0,0.0106382978723404,0.0425531914893617,0.627659574468085,0.25531914893617,0.0638297872340425,0.797872340425532,0,0.0266666666666667,0.626666666666667,0.266666666666667,0.08,0.202127659574468,0.0526315789473684,0.105263157894737,0.631578947368421,0.210526315789474,0
"25027733000",2017,33,0,2,22,8,1,28,0,1,20,6,1,5,0,1,2,2,0,0,0.0606060606060606,0.666666666666667,0.242424242424242,0.0303030303030303,0.848484848484849,0,0.0357142857142857,0.714285714285714,0.214285714285714,0.0357142857142857,0.151515151515152,0,0.2,0.4,0.4,0
"25027733101",2017,40,0,4,32,4,0,32,0,3,25,4,0,8,0,1,7,0,0,0,0.1,0.8,0.1,0,0.8,0,0.09375,0.78125,0.125,0,0.2,0,0.125,0.875,0,0
"25027733102",2017,49,0,5,30,12,2,41,0,5,25,9,2,8,0,0,5,3,0,0,0.102040816326531,0.612244897959184,0.244897959183673,0.0408163265306122,0.836734693877551,0,0.121951219512195,0.609756097560976,0.219512195121951,0.0487804878048781,0.163265306122449,0,0,0.625,0.375,0
"25027735100",2017,79,0,2,42,24,11,69,0,2,35,23,9,10,0,0,7,1,2,0,0.0253164556962025,0.531645569620253,0.30379746835443,0.139240506329114,0.873417721518987,0,0.0289855072463768,0.507246376811594,0.333333333333333,0.130434782608696,0.126582278481013,0,0,0.7,0.1,0.2
"25027735200",2017,69,1,2,31,28,7,57,0,2,23,26,6,12,1,0,8,2,1,0.0144927536231884,0.0289855072463768,0.449275362318841,0.405797101449275,0.101449275362319,0.826086956521739,0,0.0350877192982456,0.403508771929825,0.456140350877193,0.105263157894737,0.173913043478261,0.0833333333333333,0,0.666666666666667,0.166666666666667,0.0833333333333333
"25027736100",2017,56,0,2,26,18,10,50,0,2,23,16,9,6,0,0,3,2,1,0,0.0357142857142857,0.464285714285714,0.321428571428571,0.178571428571429,0.892857142857143,0,0.04,0.46,0.32,0.18,0.107142857142857,0,0,0.5,0.333333333333333,0.166666666666667
"25027736200",2017,62,0,1,33,14,14,57,0,1,30,14,12,5,0,0,3,0,2,0,0.0161290322580645,0.532258064516129,0.225806451612903,0.225806451612903,0.919354838709677,0,0.0175438596491228,0.526315789473684,0.245614035087719,0.210526315789474,0.0806451612903226,0,0,0.6,0,0.4
"25027736300",2017,51,0,1,30,15,5,45,0,0,28,13,4,6,0,1,2,2,1,0,0.0196078431372549,0.588235294117647,0.294117647058824,0.0980392156862745,0.882352941176471,0,0,0.622222222222222,0.288888888888889,0.0888888888888889,0.117647058823529,0,0.166666666666667,0.333333333333333,0.333333333333333,0.166666666666667
"25027736400",2017,52,0,4,15,25,8,45,0,2,15,21,7,7,0,2,0,4,1,0,0.0769230769230769,0.288461538461538,0.480769230769231,0.153846153846154,0.865384615384615,0,0.0444444444444444,0.333333333333333,0.466666666666667,0.155555555555556,0.134615384615385,0,0.285714285714286,0,0.571428571428571,0.142857142857143
"25027736500",2017,52,0,1,19,20,12,49,0,1,18,18,12,3,0,0,1,2,0,0,0.0192307692307692,0.365384615384615,0.384615384615385,0.230769230769231,0.942307692307692,0,0.0204081632653061,0.36734693877551,0.36734693877551,0.244897959183673,0.0576923076923077,0,0,0.333333333333333,0.666666666666667,0
"25027737100",2017,79,0,1,31,27,20,72,0,1,27,25,19,7,0,0,4,2,1,0,0.0126582278481013,0.392405063291139,0.341772151898734,0.253164556962025,0.911392405063291,0,0.0138888888888889,0.375,0.347222222222222,0.263888888888889,0.0886075949367089,0,0,0.571428571428571,0.285714285714286,0.142857142857143
"25027737200",2017,26,0,1,9,13,3,21,0,0,7,11,3,5,0,1,2,2,0,0,0.0384615384615385,0.346153846153846,0.5,0.115384615384615,0.807692307692308,0,0,0.333333333333333,0.523809523809524,0.142857142857143,0.192307692307692,0,0.2,0.4,0.4,0
"25027737300",2017,126,0,2,39,58,27,118,0,2,36,55,25,8,0,0,3,3,2,0,0.0158730158730159,0.30952380952381,0.46031746031746,0.214285714285714,0.936507936507937,0,0.0169491525423729,0.305084745762712,0.466101694915254,0.211864406779661,0.0634920634920635,0,0,0.375,0.375,0.25
"25027738100",2017,91,0,1,19,36,35,86,0,1,19,33,33,5,0,0,0,3,2,0,0.010989010989011,0.208791208791209,0.395604395604396,0.384615384615385,0.945054945054945,0,0.0116279069767442,0.22093023255814,0.383720930232558,0.383720930232558,0.0549450549450549,0,0,0,0.6,0.4
"25027738201",2017,80,0,1,23,30,26,75,0,0,23,28,24,5,0,1,0,2,2,0,0.0125,0.2875,0.375,0.325,0.9375,0,0,0.306666666666667,0.373333333333333,0.32,0.0625,0,0.2,0,0.4,0.4
"25027738202",2017,117,0,1,15,36,65,110,0,1,12,35,62,7,0,0,3,1,3,0,0.00854700854700855,0.128205128205128,0.307692307692308,0.555555555555556,0.94017094017094,0,0.00909090909090909,0.109090909090909,0.318181818181818,0.563636363636364,0.0598290598290598,0,0,0.428571428571429,0.142857142857143,0.428571428571429
"25027739100",2017,138,2,1,27,46,62,122,0,0,25,41,56,16,2,1,2,5,6,0.0144927536231884,0.0072463768115942,0.195652173913043,0.333333333333333,0.449275362318841,0.884057971014493,0,0,0.204918032786885,0.336065573770492,0.459016393442623,0.115942028985507,0.125,0.0625,0.125,0.3125,0.375
"25027739200",2017,106,0,1,26,39,40,96,0,0,23,35,38,10,0,1,3,4,2,0,0.00943396226415094,0.245283018867925,0.367924528301887,0.377358490566038,0.905660377358491,0,0,0.239583333333333,0.364583333333333,0.395833333333333,0.0943396226415094,0,0.1,0.3,0.4,0.2
"25027739300",2017,69,0,1,20,31,17,65,0,1,18,30,16,4,0,0,2,1,1,0,0.0144927536231884,0.289855072463768,0.449275362318841,0.246376811594203,0.942028985507246,0,0.0153846153846154,0.276923076923077,0.461538461538462,0.246153846153846,0.0579710144927536,0,0,0.5,0.25,0.25
"25027739400",2017,108,0,1,15,27,65,104,0,1,13,26,64,4,0,0,2,1,1,0,0.00925925925925926,0.138888888888889,0.25,0.601851851851852,0.962962962962963,0,0.00961538461538462,0.125,0.25,0.615384615384615,0.037037037037037,0,0,0.5,0.25,0.25
"25027739500",2017,116,0,2,17,26,71,101,0,0,14,24,63,15,0,2,3,2,8,0,0.0172413793103448,0.146551724137931,0.224137931034483,0.612068965517241,0.870689655172414,0,0,0.138613861386139,0.237623762376238,0.623762376237624,0.129310344827586,0,0.133333333333333,0.2,0.133333333333333,0.533333333333333
"25027740101",2017,83,0,0,14,27,42,81,0,0,14,25,42,2,0,0,0,2,0,0,0,0.168674698795181,0.325301204819277,0.506024096385542,0.975903614457831,0,0,0.172839506172839,0.308641975308642,0.518518518518518,0.0240963855421687,0,0,0,1,0
"25027740102",2017,108,0,0,19,44,45,101,0,0,17,40,44,7,0,0,2,4,1,0,0,0.175925925925926,0.407407407407407,0.416666666666667,0.935185185185185,0,0,0.168316831683168,0.396039603960396,0.435643564356436,0.0648148148148148,0,0,0.285714285714286,0.571428571428571,0.142857142857143
"25027740200",2017,57,0,0,12,23,22,50,0,0,7,23,20,7,0,0,5,0,2,0,0,0.210526315789474,0.403508771929825,0.385964912280702,0.87719298245614,0,0,0.14,0.46,0.4,0.12280701754386,0,0,0.714285714285714,0,0.285714285714286
"25027741101",2017,86,0,0,11,19,56,78,0,0,10,16,52,8,0,0,1,3,4,0,0,0.127906976744186,0.22093023255814,0.651162790697674,0.906976744186046,0,0,0.128205128205128,0.205128205128205,0.666666666666667,0.0930232558139535,0,0,0.125,0.375,0.5
"25027741102",2017,96,0,1,2,30,63,93,0,1,1,30,61,3,0,0,1,0,2,0,0.0104166666666667,0.0208333333333333,0.3125,0.65625,0.96875,0,0.010752688172043,0.010752688172043,0.32258064516129,0.655913978494624,0.03125,0,0,0.333333333333333,0,0.666666666666667
"25027742300",2017,57,0,0,14,16,27,53,0,0,12,15,26,4,0,0,2,1,1,0,0,0.245614035087719,0.280701754385965,0.473684210526316,0.929824561403509,0,0,0.226415094339623,0.283018867924528,0.490566037735849,0.0701754385964912,0,0,0.5,0.25,0.25
"25027742401",2017,81,0,0,0,13,68,81,0,0,0,13,68,0,0,0,0,0,0,0,0,0,0.160493827160494,0.839506172839506,1,0,0,0,0.160493827160494,0.839506172839506,0,0,0,0,0,0
"25027742402",2017,83,0,2,7,19,55,77,0,2,7,19,49,6,0,0,0,0,6,0,0.0240963855421687,0.0843373493975904,0.228915662650602,0.662650602409639,0.927710843373494,0,0.025974025974026,0.0909090909090909,0.246753246753247,0.636363636363636,0.072289156626506,0,0,0,0,1
"25027743100",2017,150,0,1,17,48,84,138,0,1,13,44,80,12,0,0,4,4,4,0,0.00666666666666667,0.113333333333333,0.32,0.56,0.92,0,0.0072463768115942,0.0942028985507246,0.318840579710145,0.579710144927536,0.08,0,0,0.333333333333333,0.333333333333333,0.333333333333333
"25027744101",2017,150,0,3,42,58,47,137,0,2,36,55,44,13,0,1,6,3,3,0,0.02,0.28,0.386666666666667,0.313333333333333,0.913333333333333,0,0.0145985401459854,0.262773722627737,0.401459854014599,0.321167883211679,0.0866666666666667,0,0.0769230769230769,0.461538461538462,0.230769230769231,0.230769230769231
"25027744102",2017,113,0,1,28,46,38,104,0,1,26,42,35,9,0,0,2,4,3,0,0.00884955752212389,0.247787610619469,0.407079646017699,0.336283185840708,0.920353982300885,0,0.00961538461538462,0.25,0.403846153846154,0.336538461538462,0.079646017699115,0,0,0.222222222222222,0.444444444444444,0.333333333333333
"25027744200",2017,112,0,2,47,41,22,104,0,1,43,40,20,8,0,1,4,1,2,0,0.0178571428571429,0.419642857142857,0.366071428571429,0.196428571428571,0.928571428571429,0,0.00961538461538462,0.413461538461538,0.384615384615385,0.192307692307692,0.0714285714285714,0,0.125,0.5,0.125,0.25
"25027744300",2017,42,0,1,27,10,4,40,0,0,27,9,4,2,0,1,0,1,0,0,0.0238095238095238,0.642857142857143,0.238095238095238,0.0952380952380952,0.952380952380952,0,0,0.675,0.225,0.1,0.0476190476190476,0,0.5,0,0.5,0
"25027744400",2017,58,1,1,26,16,14,50,0,1,20,16,13,8,1,0,6,0,1,0.0172413793103448,0.0172413793103448,0.448275862068966,0.275862068965517,0.241379310344828,0.862068965517241,0,0.02,0.4,0.32,0.26,0.137931034482759,0.125,0,0.75,0,0.125
"25027745100",2017,96,0,2,27,35,32,89,0,2,24,34,29,7,0,0,3,1,3,0,0.0208333333333333,0.28125,0.364583333333333,0.333333333333333,0.927083333333333,0,0.0224719101123595,0.269662921348315,0.382022471910112,0.325842696629214,0.0729166666666667,0,0,0.428571428571429,0.142857142857143,0.428571428571429
"25027746100",2017,92,0,0,15,23,54,88,0,0,15,22,51,4,0,0,0,1,3,0,0,0.16304347826087,0.25,0.58695652173913,0.956521739130435,0,0,0.170454545454545,0.25,0.579545454545455,0.0434782608695652,0,0,0,0.25,0.75
"25027747101",2017,87,0,4,31,29,23,79,0,3,27,27,22,8,0,1,4,2,1,0,0.0459770114942529,0.35632183908046,0.333333333333333,0.264367816091954,0.908045977011494,0,0.0379746835443038,0.341772151898734,0.341772151898734,0.278481012658228,0.0919540229885057,0,0.125,0.5,0.25,0.125
"25027747102",2017,55,0,1,25,21,8,51,0,1,23,20,7,4,0,0,2,1,1,0,0.0181818181818182,0.454545454545455,0.381818181818182,0.145454545454545,0.927272727272727,0,0.0196078431372549,0.450980392156863,0.392156862745098,0.137254901960784,0.0727272727272727,0,0,0.5,0.25,0.25
"25027748100",2017,47,0,0,24,16,7,43,0,0,21,15,7,4,0,0,3,1,0,0,0,0.51063829787234,0.340425531914894,0.148936170212766,0.914893617021277,0,0,0.488372093023256,0.348837209302326,0.162790697674419,0.0851063829787234,0,0,0.75,0.25,0
"25027749100",2017,164,0,4,50,61,49,148,0,3,42,58,45,16,0,1,8,3,4,0,0.024390243902439,0.304878048780488,0.371951219512195,0.298780487804878,0.902439024390244,0,0.0202702702702703,0.283783783783784,0.391891891891892,0.304054054054054,0.0975609756097561,0,0.0625,0.5,0.1875,0.25
"25027749200",2017,74,0,2,27,32,13,71,0,2,24,32,13,3,0,0,3,0,0,0,0.027027027027027,0.364864864864865,0.432432432432432,0.175675675675676,0.959459459459459,0,0.028169014084507,0.338028169014085,0.450704225352113,0.183098591549296,0.0405405405405405,0,0,1,0,0
"25027750100",2017,91,1,2,31,30,27,83,0,2,28,28,25,8,1,0,3,2,2,0.010989010989011,0.021978021978022,0.340659340659341,0.32967032967033,0.296703296703297,0.912087912087912,0,0.0240963855421687,0.337349397590361,0.337349397590361,0.301204819277108,0.0879120879120879,0.125,0,0.375,0.25,0.25
"25027750200",2017,129,0,2,44,55,28,123,0,2,39,54,28,6,0,0,5,1,0,0,0.0155038759689922,0.341085271317829,0.426356589147287,0.217054263565891,0.953488372093023,0,0.016260162601626,0.317073170731707,0.439024390243902,0.227642276422764,0.0465116279069767,0,0,0.833333333333333,0.166666666666667,0
"25027750300",2017,49,0,1,14,20,14,44,0,1,14,16,13,5,0,0,0,4,1,0,0.0204081632653061,0.285714285714286,0.408163265306122,0.285714285714286,0.897959183673469,0,0.0227272727272727,0.318181818181818,0.363636363636364,0.295454545454545,0.102040816326531,0,0,0,0.8,0.2
"25027751101",2017,86,0,0,21,39,26,79,0,0,18,36,25,7,0,0,3,3,1,0,0,0.244186046511628,0.453488372093023,0.302325581395349,0.918604651162791,0,0,0.227848101265823,0.455696202531646,0.316455696202532,0.0813953488372093,0,0,0.428571428571429,0.428571428571429,0.142857142857143
"25027751102",2017,41,0,0,4,15,22,36,0,0,3,15,18,5,0,0,1,0,4,0,0,0.0975609756097561,0.365853658536585,0.536585365853659,0.878048780487805,0,0,0.0833333333333333,0.416666666666667,0.5,0.121951219512195,0,0,0.2,0,0.8
"25027752100",2017,137,1,0,34,51,51,128,1,0,32,47,48,9,0,0,2,4,3,0.0072992700729927,0,0.248175182481752,0.372262773722628,0.372262773722628,0.934306569343066,0.0078125,0,0.25,0.3671875,0.375,0.0656934306569343,0,0,0.222222222222222,0.444444444444444,0.333333333333333
"25027753100",2017,146,0,2,63,54,27,132,0,2,56,50,24,14,0,0,7,4,3,0,0.0136986301369863,0.431506849315068,0.36986301369863,0.184931506849315,0.904109589041096,0,0.0151515151515152,0.424242424242424,0.378787878787879,0.181818181818182,0.0958904109589041,0,0,0.5,0.285714285714286,0.214285714285714
"25027753200",2017,82,0,2,45,28,7,70,0,1,38,24,7,12,0,1,7,4,0,0,0.024390243902439,0.548780487804878,0.341463414634146,0.0853658536585366,0.853658536585366,0,0.0142857142857143,0.542857142857143,0.342857142857143,0.1,0.146341463414634,0,0.0833333333333333,0.583333333333333,0.333333333333333,0
"25027754100",2017,145,0,5,64,49,27,127,0,3,54,45,25,18,0,2,10,4,2,0,0.0344827586206897,0.441379310344828,0.337931034482759,0.186206896551724,0.875862068965517,0,0.0236220472440945,0.425196850393701,0.354330708661417,0.196850393700787,0.124137931034483,0,0.111111111111111,0.555555555555556,0.222222222222222,0.111111111111111
"25027754200",2017,45,0,3,34,8,0,38,0,3,27,8,0,7,0,0,7,0,0,0,0.0666666666666667,0.755555555555556,0.177777777777778,0,0.844444444444444,0,0.0789473684210526,0.710526315789474,0.210526315789474,0,0.155555555555556,0,0,1,0,0
"25027754300",2017,17,0,3,13,1,0,17,0,3,13,1,0,0,0,0,0,0,0,0,0.176470588235294,0.764705882352941,0.0588235294117647,0,1,0,0.176470588235294,0.764705882352941,0.0588235294117647,0,0,0,0,0,0,0
"25027754400",2017,63,0,5,38,14,6,51,0,4,33,10,4,12,0,1,5,4,2,0,0.0793650793650794,0.603174603174603,0.222222222222222,0.0952380952380952,0.80952380952381,0,0.0784313725490196,0.647058823529412,0.196078431372549,0.0784313725490196,0.19047619047619,0,0.0833333333333333,0.416666666666667,0.333333333333333,0.166666666666667
"25027755100",2017,46,1,3,29,10,3,41,0,3,25,10,3,5,1,0,4,0,0,0.0217391304347826,0.0652173913043478,0.630434782608696,0.217391304347826,0.0652173913043478,0.891304347826087,0,0.0731707317073171,0.609756097560976,0.24390243902439,0.0731707317073171,0.108695652173913,0.2,0,0.8,0,0
"25027755200",2017,105,1,2,49,38,15,94,1,1,44,33,15,11,0,1,5,5,0,0.00952380952380952,0.019047619047619,0.466666666666667,0.361904761904762,0.142857142857143,0.895238095238095,0.0106382978723404,0.0106382978723404,0.468085106382979,0.351063829787234,0.159574468085106,0.104761904761905,0,0.0909090909090909,0.454545454545455,0.454545454545455,0
"25027756101",2017,84,1,4,28,31,20,76,0,3,25,29,19,8,1,1,3,2,1,0.0119047619047619,0.0476190476190476,0.333333333333333,0.369047619047619,0.238095238095238,0.904761904761905,0,0.0394736842105263,0.328947368421053,0.381578947368421,0.25,0.0952380952380952,0.125,0.125,0.375,0.25,0.125
"25027756102",2017,121,0,2,29,57,33,108,0,2,26,53,27,13,0,0,3,4,6,0,0.0165289256198347,0.239669421487603,0.471074380165289,0.272727272727273,0.892561983471074,0,0.0185185185185185,0.240740740740741,0.490740740740741,0.25,0.107438016528926,0,0,0.230769230769231,0.307692307692308,0.461538461538462
"25027757100",2017,48,0,4,34,9,1,39,0,4,28,7,0,9,0,0,6,2,1,0,0.0833333333333333,0.708333333333333,0.1875,0.0208333333333333,0.8125,0,0.102564102564103,0.717948717948718,0.179487179487179,0,0.1875,0,0,0.666666666666667,0.222222222222222,0.111111111111111
"25027757200",2017,19,0,0,16,3,0,15,0,0,12,3,0,4,0,0,4,0,0,0,0,0.842105263157895,0.157894736842105,0,0.789473684210526,0,0,0.8,0.2,0,0.210526315789474,0,0,1,0,0
"25027757300",2017,20,0,4,9,6,1,19,0,4,9,5,1,1,0,0,0,1,0,0,0.2,0.45,0.3,0.05,0.95,0,0.210526315789474,0.473684210526316,0.263157894736842,0.0526315789473684,0.05,0,0,0,1,0
"25027757400",2017,38,0,1,25,10,2,30,0,0,20,8,2,8,0,1,5,2,0,0,0.0263157894736842,0.657894736842105,0.263157894736842,0.0526315789473684,0.789473684210526,0,0,0.666666666666667,0.266666666666667,0.0666666666666667,0.210526315789474,0,0.125,0.625,0.25,0
"25027757500",2017,78,0,4,44,23,7,70,0,1,43,19,7,8,0,3,1,4,0,0,0.0512820512820513,0.564102564102564,0.294871794871795,0.0897435897435897,0.897435897435897,0,0.0142857142857143,0.614285714285714,0.271428571428571,0.1,0.102564102564103,0,0.375,0.125,0.5,0
"25027758101",2017,33,0,1,11,13,8,25,0,0,8,11,6,8,0,1,3,2,2,0,0.0303030303030303,0.333333333333333,0.393939393939394,0.242424242424242,0.757575757575758,0,0,0.32,0.44,0.24,0.242424242424242,0,0.125,0.375,0.25,0.25
"25027758102",2017,160,0,5,41,46,68,147,0,2,37,43,65,13,0,3,4,3,3,0,0.03125,0.25625,0.2875,0.425,0.91875,0,0.0136054421768707,0.251700680272109,0.292517006802721,0.442176870748299,0.08125,0,0.230769230769231,0.307692307692308,0.230769230769231,0.230769230769231
"25027759100",2017,43,0,0,23,12,8,41,0,0,21,12,8,2,0,0,2,0,0,0,0,0.534883720930233,0.27906976744186,0.186046511627907,0.953488372093023,0,0,0.51219512195122,0.292682926829268,0.195121951219512,0.0465116279069767,0,0,1,0,0
"25027760100",2017,45,0,7,23,11,4,40,0,4,21,11,4,5,0,3,2,0,0,0,0.155555555555556,0.511111111111111,0.244444444444444,0.0888888888888889,0.888888888888889,0,0.1,0.525,0.275,0.1,0.111111111111111,0,0.6,0.4,0,0
"25027761100",2017,75,0,7,32,27,9,60,0,6,25,20,9,15,0,1,7,7,0,0,0.0933333333333333,0.426666666666667,0.36,0.12,0.8,0,0.1,0.416666666666667,0.333333333333333,0.15,0.2,0,0.0666666666666667,0.466666666666667,0.466666666666667,0
"25027761200",2017,50,0,0,9,22,19,47,0,0,8,20,19,3,0,0,1,2,0,0,0,0.18,0.44,0.38,0.94,0,0,0.170212765957447,0.425531914893617,0.404255319148936,0.06,0,0,0.333333333333333,0.666666666666667,0
"25027761300",2017,57,0,0,21,25,11,52,0,0,18,23,11,5,0,0,3,2,0,0,0,0.368421052631579,0.43859649122807,0.192982456140351,0.912280701754386,0,0,0.346153846153846,0.442307692307692,0.211538461538462,0.087719298245614,0,0,0.6,0.4,0
"25027761400",2017,71,0,1,7,15,48,68,0,1,7,14,46,3,0,0,0,1,2,0,0.0140845070422535,0.0985915492957746,0.211267605633803,0.676056338028169,0.957746478873239,0,0.0147058823529412,0.102941176470588,0.205882352941176,0.676470588235294,0.0422535211267606,0,0,0,0.333333333333333,0.666666666666667
